,Method,YY_MM,Quantity of Units Issued,Quantity of Units,Rolling_Issuance,Rolling_Retirement,Balance,Retirement_Ratio
0,ACoGS,23_01,316781.0,0.0,316781.0,0.0,316781.0,0.0
1,ACoGS,23_07,0.0,2.0,316781.0,2.0,316779.0,6.313509964297101e-06
2,ALM,14_02,21565.0,0.0,21565.0,0.0,21565.0,0.0
3,ALM,17_06,143905.0,0.0,165470.0,0.0,165470.0,0.0
4,ALM,19_01,160355.0,0.0,325825.0,0.0,325825.0,0.0
5,ALM,21_05,12795.0,0.0,338620.0,0.0,338620.0,0.0
6,ALM,21_06,547260.0,0.0,885880.0,0.0,885880.0,0.0
7,ALM,21_07,511700.0,0.0,1397580.0,0.0,1397580.0,0.0
8,ALM,21_11,180000.0,0.0,1577580.0,0.0,1577580.0,0.0
9,ALM,21_12,1527285.0,0.0,3104865.0,0.0,3104865.0,0.0
10,ALM,22_01,1151539.0,0.0,4256404.0,0.0,4256404.0,0.0
11,ALM,22_04,900000.0,0.0,5156404.0,0.0,5156404.0,0.0
12,ALM,22_07,480000.0,0.0,5636404.0,0.0,5636404.0,0.0
13,ALM,22_09,300000.0,0.0,5936404.0,0.0,5936404.0,0.0
14,ALM,22_10,420000.0,0.0,6356404.0,0.0,6356404.0,0.0
15,ALM,22_11,3478517.0,0.0,9834921.0,0.0,9834921.0,0.0
16,ALM,22_12,791978.0,0.0,10626899.0,0.0,10626899.0,0.0
17,ALM,23_01,1171403.0,0.0,11798302.0,0.0,11798302.0,0.0
18,ALM,23_02,205000.0,0.0,12003302.0,0.0,12003302.0,0.0
19,ALM,23_06,678291.0,1534.0,12681593.0,1534.0,12680059.0,0.00012096272132373276
20,ALM,23_07,0.0,2451.0,12681593.0,3985.0,12677608.0,0.0003142349703227347
21,ARR,10_09,139358.0,0.0,139358.0,0.0,139358.0,0.0
22,ARR,11_04,10742.0,0.0,150100.0,0.0,150100.0,0.0
23,ARR,11_07,64501.0,0.0,214601.0,0.0,214601.0,0.0
24,ARR,11_08,185901.0,0.0,400502.0,0.0,400502.0,0.0
25,ARR,11_09,372381.0,0.0,772883.0,0.0,772883.0,0.0
26,ARR,11_12,61772.0,0.0,834655.0,0.0,834655.0,0.0
27,ARR,12_03,44000.0,0.0,878655.0,0.0,878655.0,0.0
28,ARR,12_04,5000.0,0.0,883655.0,0.0,883655.0,0.0
29,ARR,12_05,115306.0,0.0,998961.0,0.0,998961.0,0.0
30,ARR,12_06,14002.0,0.0,1012963.0,0.0,1012963.0,0.0
31,ARR,12_07,11619.0,0.0,1024582.0,0.0,1024582.0,0.0
32,ARR,12_10,169784.0,0.0,1194366.0,0.0,1194366.0,0.0
33,ARR,13_01,753.0,0.0,1195119.0,0.0,1195119.0,0.0
34,ARR,13_03,159461.0,0.0,1354580.0,0.0,1354580.0,0.0
35,ARR,13_04,75005.0,0.0,1429585.0,0.0,1429585.0,0.0
36,ARR,13_05,13000.0,0.0,1442585.0,0.0,1442585.0,0.0
37,ARR,13_07,22790.0,0.0,1465375.0,0.0,1465375.0,0.0
38,ARR,13_08,31006.0,0.0,1496381.0,0.0,1496381.0,0.0
39,ARR,13_12,690.0,0.0,1497071.0,0.0,1497071.0,0.0
40,ARR,14_03,51120.0,0.0,1548191.0,0.0,1548191.0,0.0
41,ARR,14_06,480.0,0.0,1548671.0,0.0,1548671.0,0.0
42,ARR,14_07,59738.0,0.0,1608409.0,0.0,1608409.0,0.0
43,ARR,14_08,34156.0,0.0,1642565.0,0.0,1642565.0,0.0
44,ARR,14_09,113998.0,0.0,1756563.0,0.0,1756563.0,0.0
45,ARR,14_10,141631.0,0.0,1898194.0,0.0,1898194.0,0.0
46,ARR,14_12,83860.0,0.0,1982054.0,0.0,1982054.0,0.0
47,ARR,15_01,6500.0,0.0,1988554.0,0.0,1988554.0,0.0
48,ARR,15_02,43333.0,0.0,2031887.0,0.0,2031887.0,0.0
49,ARR,15_03,3500.0,0.0,2035387.0,0.0,2035387.0,0.0
50,ARR,15_04,110447.0,0.0,2145834.0,0.0,2145834.0,0.0
51,ARR,15_09,75081.0,0.0,2220915.0,0.0,2220915.0,0.0
52,ARR,15_10,30608.0,0.0,2251523.0,0.0,2251523.0,0.0
53,ARR,15_12,76900.0,0.0,2328423.0,0.0,2328423.0,0.0
54,ARR,16_01,155391.0,0.0,2483814.0,0.0,2483814.0,0.0
55,ARR,16_03,5959.0,0.0,2489773.0,0.0,2489773.0,0.0
56,ARR,16_04,21000.0,0.0,2510773.0,0.0,2510773.0,0.0
57,ARR,16_05,38125.0,0.0,2548898.0,0.0,2548898.0,0.0
58,ARR,16_06,2638.0,0.0,2551536.0,0.0,2551536.0,0.0
59,ARR,16_07,34295.0,0.0,2585831.0,0.0,2585831.0,0.0
60,ARR,16_09,56100.0,0.0,2641931.0,0.0,2641931.0,0.0
61,ARR,16_10,1000.0,0.0,2642931.0,0.0,2642931.0,0.0
62,ARR,16_11,95591.0,0.0,2738522.0,0.0,2738522.0,0.0
63,ARR,16_12,115853.0,0.0,2854375.0,0.0,2854375.0,0.0
64,ARR,17_02,6207.0,0.0,2860582.0,0.0,2860582.0,0.0
65,ARR,17_03,19000.0,0.0,2879582.0,0.0,2879582.0,0.0
66,ARR,17_04,56889.0,0.0,2936471.0,0.0,2936471.0,0.0
67,ARR,17_05,650.0,0.0,2937121.0,0.0,2937121.0,0.0
68,ARR,17_06,86897.0,0.0,3024018.0,0.0,3024018.0,0.0
69,ARR,17_07,121872.0,0.0,3145890.0,0.0,3145890.0,0.0
70,ARR,17_08,118700.0,0.0,3264590.0,0.0,3264590.0,0.0
71,ARR,17_09,21000.0,0.0,3285590.0,0.0,3285590.0,0.0
72,ARR,17_10,86841.0,0.0,3372431.0,0.0,3372431.0,0.0
73,ARR,17_11,10000.0,0.0,3382431.0,0.0,3382431.0,0.0
74,ARR,17_12,378802.0,0.0,3761233.0,0.0,3761233.0,0.0
75,ARR,18_01,1000.0,0.0,3762233.0,0.0,3762233.0,0.0
76,ARR,18_02,161093.0,0.0,3923326.0,0.0,3923326.0,0.0
77,ARR,18_04,12849.0,0.0,3936175.0,0.0,3936175.0,0.0
78,ARR,18_06,100000.0,0.0,4036175.0,0.0,4036175.0,0.0
79,ARR,18_07,29480.0,0.0,4065655.0,0.0,4065655.0,0.0
80,ARR,18_08,96221.0,0.0,4161876.0,0.0,4161876.0,0.0
81,ARR,18_09,36365.0,0.0,4198241.0,0.0,4198241.0,0.0
82,ARR,18_10,23345.0,0.0,4221586.0,0.0,4221586.0,0.0
83,ARR,18_11,84663.0,0.0,4306249.0,0.0,4306249.0,0.0
84,ARR,18_12,185477.0,0.0,4491726.0,0.0,4491726.0,0.0
85,ARR,19_01,40000.0,0.0,4531726.0,0.0,4531726.0,0.0
86,ARR,19_02,13015.0,0.0,4544741.0,0.0,4544741.0,0.0
87,ARR,19_03,65872.0,0.0,4610613.0,0.0,4610613.0,0.0
88,ARR,19_04,200612.0,0.0,4811225.0,0.0,4811225.0,0.0
89,ARR,19_05,346406.0,0.0,5157631.0,0.0,5157631.0,0.0
90,ARR,19_06,84970.0,0.0,5242601.0,0.0,5242601.0,0.0
91,ARR,19_07,31860.0,0.0,5274461.0,0.0,5274461.0,0.0
92,ARR,19_08,49746.0,0.0,5324207.0,0.0,5324207.0,0.0
93,ARR,19_09,187861.0,0.0,5512068.0,0.0,5512068.0,0.0
94,ARR,19_10,158414.0,0.0,5670482.0,0.0,5670482.0,0.0
95,ARR,19_11,197000.0,0.0,5867482.0,0.0,5867482.0,0.0
96,ARR,19_12,696243.0,0.0,6563725.0,0.0,6563725.0,0.0
97,ARR,20_01,198722.0,0.0,6762447.0,0.0,6762447.0,0.0
98,ARR,20_02,1259132.0,0.0,8021579.0,0.0,8021579.0,0.0
99,ARR,20_03,1352501.0,0.0,9374080.0,0.0,9374080.0,0.0
100,ARR,20_04,650137.0,0.0,10024217.0,0.0,10024217.0,0.0
101,ARR,20_05,335568.0,0.0,10359785.0,0.0,10359785.0,0.0
102,ARR,20_06,346152.0,0.0,10705937.0,0.0,10705937.0,0.0
103,ARR,20_07,627676.0,0.0,11333613.0,0.0,11333613.0,0.0
104,ARR,20_08,289023.0,0.0,11622636.0,0.0,11622636.0,0.0
105,ARR,20_09,440564.0,0.0,12063200.0,0.0,12063200.0,0.0
106,ARR,20_10,257765.0,0.0,12320965.0,0.0,12320965.0,0.0
107,ARR,20_11,418613.0,0.0,12739578.0,0.0,12739578.0,0.0
108,ARR,20_12,1051329.0,0.0,13790907.0,0.0,13790907.0,0.0
109,ARR,21_01,1107504.0,0.0,14898411.0,0.0,14898411.0,0.0
110,ARR,21_02,1217126.0,0.0,16115537.0,0.0,16115537.0,0.0
111,ARR,21_03,1559641.0,0.0,17675178.0,0.0,17675178.0,0.0
112,ARR,21_04,1577387.0,0.0,19252565.0,0.0,19252565.0,0.0
113,ARR,21_05,2349996.0,0.0,21602561.0,0.0,21602561.0,0.0
114,ARR,21_06,1191812.0,0.0,22794373.0,0.0,22794373.0,0.0
115,ARR,21_07,1969826.0,0.0,24764199.0,0.0,24764199.0,0.0
116,ARR,21_08,469279.0,0.0,25233478.0,0.0,25233478.0,0.0
117,ARR,21_09,417012.0,0.0,25650490.0,0.0,25650490.0,0.0
118,ARR,21_10,164744.0,0.0,25815234.0,0.0,25815234.0,0.0
119,ARR,21_11,642779.0,0.0,26458013.0,0.0,26458013.0,0.0
120,ARR,21_12,2852276.0,0.0,29310289.0,0.0,29310289.0,0.0
121,ARR,22_01,2453867.0,0.0,31764156.0,0.0,31764156.0,0.0
122,ARR,22_02,713653.0,0.0,32477809.0,0.0,32477809.0,0.0
123,ARR,22_03,1007293.0,0.0,33485102.0,0.0,33485102.0,0.0
124,ARR,22_04,2386966.0,0.0,35872068.0,0.0,35872068.0,0.0
125,ARR,22_05,606180.0,0.0,36478248.0,0.0,36478248.0,0.0
126,ARR,22_06,1234721.0,0.0,37712969.0,0.0,37712969.0,0.0
127,ARR,22_07,462433.0,0.0,38175402.0,0.0,38175402.0,0.0
128,ARR,22_08,200000.0,0.0,38375402.0,0.0,38375402.0,0.0
129,ARR,22_09,853449.0,0.0,39228851.0,0.0,39228851.0,0.0
130,ARR,22_10,450267.0,0.0,39679118.0,0.0,39679118.0,0.0
131,ARR,22_11,569235.0,0.0,40248353.0,0.0,40248353.0,0.0
132,ARR,22_12,398391.0,0.0,40646744.0,0.0,40646744.0,0.0
133,ARR,23_01,851808.0,0.0,41498552.0,0.0,41498552.0,0.0
134,ARR,23_02,1257620.0,0.0,42756172.0,0.0,42756172.0,0.0
135,ARR,23_03,1798368.0,0.0,44554540.0,0.0,44554540.0,0.0
136,ARR,23_04,359796.0,0.0,44914336.0,0.0,44914336.0,0.0
137,ARR,23_05,155442.0,0.0,45069778.0,0.0,45069778.0,0.0
138,ARR,23_06,148398.0,611592.0,45218176.0,611592.0,44606584.0,0.013525357590717503
139,ARR,23_07,10000.0,203388.0,45228176.0,814980.0,44413196.0,0.01801929841256477
140,ARR; IFM,21_12,248558.0,0.0,248558.0,0.0,248558.0,0.0
141,ARR; IFM,23_06,0.0,314.0,248558.0,314.0,248244.0,0.0012632866373240854
142,ARR; IFM; REDD,20_03,519102.0,0.0,519102.0,0.0,519102.0,0.0
143,ARR; IFM; REDD,20_11,170715.0,0.0,689817.0,0.0,689817.0,0.0
144,ARR; REDD,13_10,100000.0,0.0,100000.0,0.0,100000.0,0.0
145,ARR; REDD,13_11,1400000.0,0.0,1500000.0,0.0,1500000.0,0.0
146,ARR; REDD,13_12,500000.0,0.0,2000000.0,0.0,2000000.0,0.0
147,ARR; REDD,14_07,5000.0,0.0,2005000.0,0.0,2005000.0,0.0
148,ARR; REDD,14_10,20000.0,0.0,2025000.0,0.0,2025000.0,0.0
149,ARR; REDD,14_12,391549.0,0.0,2416549.0,0.0,2416549.0,0.0
150,ARR; REDD,15_02,5000.0,0.0,2421549.0,0.0,2421549.0,0.0
151,ARR; REDD,15_03,331634.0,0.0,2753183.0,0.0,2753183.0,0.0
152,ARR; REDD,15_06,99915.0,0.0,2853098.0,0.0,2853098.0,0.0
153,ARR; REDD,15_07,3181.0,0.0,2856279.0,0.0,2856279.0,0.0
154,ARR; REDD,15_12,1471000.0,0.0,4327279.0,0.0,4327279.0,0.0
155,ARR; REDD,16_02,10000.0,0.0,4337279.0,0.0,4337279.0,0.0
156,ARR; REDD,16_04,10000.0,0.0,4347279.0,0.0,4347279.0,0.0
157,ARR; REDD,16_05,15000.0,0.0,4362279.0,0.0,4362279.0,0.0
158,ARR; REDD,16_06,5000.0,0.0,4367279.0,0.0,4367279.0,0.0
159,ARR; REDD,16_08,30000.0,0.0,4397279.0,0.0,4397279.0,0.0
160,ARR; REDD,16_12,30000.0,0.0,4427279.0,0.0,4427279.0,0.0
161,ARR; REDD,17_01,55000.0,0.0,4482279.0,0.0,4482279.0,0.0
162,ARR; REDD,17_02,20000.0,0.0,4502279.0,0.0,4502279.0,0.0
163,ARR; REDD,17_04,80000.0,0.0,4582279.0,0.0,4582279.0,0.0
164,ARR; REDD,17_05,50000.0,0.0,4632279.0,0.0,4632279.0,0.0
165,ARR; REDD,17_06,200000.0,0.0,4832279.0,0.0,4832279.0,0.0
166,ARR; REDD,17_09,961000.0,0.0,5793279.0,0.0,5793279.0,0.0
167,ARR; REDD,17_10,150000.0,0.0,5943279.0,0.0,5943279.0,0.0
168,ARR; REDD,17_11,10000.0,0.0,5953279.0,0.0,5953279.0,0.0
169,ARR; REDD,17_12,260000.0,0.0,6213279.0,0.0,6213279.0,0.0
170,ARR; REDD,18_03,160000.0,0.0,6373279.0,0.0,6373279.0,0.0
171,ARR; REDD,18_06,250000.0,0.0,6623279.0,0.0,6623279.0,0.0
172,ARR; REDD,18_07,120000.0,0.0,6743279.0,0.0,6743279.0,0.0
173,ARR; REDD,18_10,700000.0,0.0,7443279.0,0.0,7443279.0,0.0
174,ARR; REDD,18_11,1100000.0,0.0,8543279.0,0.0,8543279.0,0.0
175,ARR; REDD,19_06,100000.0,0.0,8643279.0,0.0,8643279.0,0.0
176,ARR; REDD,19_09,1300000.0,0.0,9943279.0,0.0,9943279.0,0.0
177,ARR; REDD,20_02,100000.0,0.0,10043279.0,0.0,10043279.0,0.0
178,ARR; REDD,20_03,553000.0,0.0,10596279.0,0.0,10596279.0,0.0
179,ARR; REDD,20_04,20000.0,0.0,10616279.0,0.0,10616279.0,0.0
180,ARR; REDD,20_05,11500.0,0.0,10627779.0,0.0,10627779.0,0.0
181,ARR; REDD,20_06,100000.0,0.0,10727779.0,0.0,10727779.0,0.0
182,ARR; REDD,20_07,400000.0,0.0,11127779.0,0.0,11127779.0,0.0
183,ARR; REDD,20_08,100000.0,0.0,11227779.0,0.0,11227779.0,0.0
184,ARR; REDD,20_09,57458.0,0.0,11285237.0,0.0,11285237.0,0.0
185,ARR; REDD,20_10,1000000.0,0.0,12285237.0,0.0,12285237.0,0.0
186,ARR; REDD,20_11,766458.0,0.0,13051695.0,0.0,13051695.0,0.0
187,ARR; REDD,20_12,99691.0,0.0,13151386.0,0.0,13151386.0,0.0
188,ARR; REDD,21_01,990973.0,0.0,14142359.0,0.0,14142359.0,0.0
189,ARR; REDD,21_02,130000.0,0.0,14272359.0,0.0,14272359.0,0.0
190,ARR; REDD,21_03,260000.0,0.0,14532359.0,0.0,14532359.0,0.0
191,ARR; REDD,21_04,200000.0,0.0,14732359.0,0.0,14732359.0,0.0
192,ARR; REDD,21_05,364137.0,0.0,15096496.0,0.0,15096496.0,0.0
193,ARR; REDD,21_06,172858.0,0.0,15269354.0,0.0,15269354.0,0.0
194,ARR; REDD,21_07,346434.0,0.0,15615788.0,0.0,15615788.0,0.0
195,ARR; REDD,21_08,75000.0,0.0,15690788.0,0.0,15690788.0,0.0
196,ARR; REDD,21_09,400000.0,0.0,16090788.0,0.0,16090788.0,0.0
197,ARR; REDD,21_10,732690.0,0.0,16823478.0,0.0,16823478.0,0.0
198,ARR; REDD,21_11,771900.0,0.0,17595378.0,0.0,17595378.0,0.0
199,ARR; REDD,21_12,1640984.0,0.0,19236362.0,0.0,19236362.0,0.0
200,ARR; REDD,22_01,426500.0,0.0,19662862.0,0.0,19662862.0,0.0
201,ARR; REDD,22_03,1021607.0,0.0,20684469.0,0.0,20684469.0,0.0
202,ARR; REDD,22_04,907467.0,0.0,21591936.0,0.0,21591936.0,0.0
203,ARR; REDD,22_05,1319808.0,0.0,22911744.0,0.0,22911744.0,0.0
204,ARR; REDD,22_06,393224.0,0.0,23304968.0,0.0,23304968.0,0.0
205,ARR; REDD,22_07,239255.0,0.0,23544223.0,0.0,23544223.0,0.0
206,ARR; REDD,22_08,530687.0,0.0,24074910.0,0.0,24074910.0,0.0
207,ARR; REDD,22_09,942732.0,0.0,25017642.0,0.0,25017642.0,0.0
208,ARR; REDD,22_10,1642311.0,0.0,26659953.0,0.0,26659953.0,0.0
209,ARR; REDD,22_12,10000.0,0.0,26669953.0,0.0,26669953.0,0.0
210,ARR; REDD,23_03,5770.0,0.0,26675723.0,0.0,26675723.0,0.0
211,ARR; REDD,23_06,0.0,39412.0,26675723.0,39412.0,26636311.0,0.0014774482401095558
212,ARR; REDD,23_07,0.0,37869.0,26675723.0,77281.0,26598442.0,0.0028970536243759916
213,ARR; REDD; WRC,17_05,1000.0,0.0,1000.0,0.0,1000.0,0.0
214,ARR; REDD; WRC,17_06,20000.0,0.0,21000.0,0.0,21000.0,0.0
215,ARR; REDD; WRC,17_09,2002000.0,0.0,2023000.0,0.0,2023000.0,0.0
216,ARR; REDD; WRC,18_04,5000.0,0.0,2028000.0,0.0,2028000.0,0.0
217,ARR; REDD; WRC,18_06,20000.0,0.0,2048000.0,0.0,2048000.0,0.0
218,ARR; REDD; WRC,18_08,3007600.0,0.0,5055600.0,0.0,5055600.0,0.0
219,ARR; REDD; WRC,18_10,2217.0,0.0,5057817.0,0.0,5057817.0,0.0
220,ARR; REDD; WRC,18_11,1000000.0,0.0,6057817.0,0.0,6057817.0,0.0
221,ARR; REDD; WRC,18_12,5000000.0,0.0,11057817.0,0.0,11057817.0,0.0
222,ARR; REDD; WRC,19_01,10860338.0,0.0,21918155.0,0.0,21918155.0,0.0
223,ARR; REDD; WRC,19_09,20000.0,0.0,21938155.0,0.0,21938155.0,0.0
224,ARR; REDD; WRC,19_11,80000.0,0.0,22018155.0,0.0,22018155.0,0.0
225,ARR; REDD; WRC,19_12,80646.0,0.0,22098801.0,0.0,22098801.0,0.0
226,ARR; REDD; WRC,20_06,1250.0,0.0,22100051.0,0.0,22100051.0,0.0
227,ARR; REDD; WRC,20_07,1320000.0,0.0,23420051.0,0.0,23420051.0,0.0
228,ARR; REDD; WRC,20_10,750000.0,0.0,24170051.0,0.0,24170051.0,0.0
229,ARR; REDD; WRC,20_11,20000.0,0.0,24190051.0,0.0,24190051.0,0.0
230,ARR; REDD; WRC,21_03,47203.0,0.0,24237254.0,0.0,24237254.0,0.0
231,ARR; REDD; WRC,21_04,1250.0,0.0,24238504.0,0.0,24238504.0,0.0
232,ARR; REDD; WRC,21_05,656261.0,0.0,24894765.0,0.0,24894765.0,0.0
233,ARR; REDD; WRC,21_06,2250550.0,0.0,27145315.0,0.0,27145315.0,0.0
234,ARR; REDD; WRC,21_07,2000000.0,0.0,29145315.0,0.0,29145315.0,0.0
235,ARR; REDD; WRC,21_09,200000.0,0.0,29345315.0,0.0,29345315.0,0.0
236,ARR; REDD; WRC,21_10,709939.0,0.0,30055254.0,0.0,30055254.0,0.0
237,ARR; REDD; WRC,21_11,1102500.0,0.0,31157754.0,0.0,31157754.0,0.0
238,ARR; REDD; WRC,22_01,1003750.0,0.0,32161504.0,0.0,32161504.0,0.0
239,ARR; REDD; WRC,22_03,6420273.0,0.0,38581777.0,0.0,38581777.0,0.0
240,ARR; REDD; WRC,23_06,0.0,74496.0,38581777.0,74496.0,38507281.0,0.0019308597424115535
241,ARR; REDD; WRC,23_07,0.0,199239.0,38581777.0,273735.0,38308042.0,0.0070949298162186775
242,ARR; WRC,18_11,31744.0,0.0,31744.0,0.0,31744.0,0.0
243,ARR; WRC,19_11,26615.0,0.0,58359.0,0.0,58359.0,0.0
244,ARR; WRC,19_12,50000.0,0.0,108359.0,0.0,108359.0,0.0
245,ARR; WRC,20_01,257244.0,0.0,365603.0,0.0,365603.0,0.0
246,ARR; WRC,20_02,300300.0,0.0,665903.0,0.0,665903.0,0.0
247,ARR; WRC,20_03,80130.0,0.0,746033.0,0.0,746033.0,0.0
248,ARR; WRC,20_04,581231.0,0.0,1327264.0,0.0,1327264.0,0.0
249,ARR; WRC,20_11,100000.0,0.0,1427264.0,0.0,1427264.0,0.0
250,ARR; WRC,20_12,53369.0,0.0,1480633.0,0.0,1480633.0,0.0
251,ARR; WRC,21_05,200000.0,0.0,1680633.0,0.0,1680633.0,0.0
252,ARR; WRC,21_08,10000.0,0.0,1690633.0,0.0,1690633.0,0.0
253,ARR; WRC,21_10,2800.0,0.0,1693433.0,0.0,1693433.0,0.0
254,ARR; WRC,21_11,30108.0,0.0,1723541.0,0.0,1723541.0,0.0
255,ARR; WRC,21_12,142920.0,0.0,1866461.0,0.0,1866461.0,0.0
256,ARR; WRC,22_01,39007.0,0.0,1905468.0,0.0,1905468.0,0.0
257,ARR; WRC,22_02,342800.0,0.0,2248268.0,0.0,2248268.0,0.0
258,ARR; WRC,22_03,151687.0,0.0,2399955.0,0.0,2399955.0,0.0
259,ARR; WRC,22_04,1150.0,0.0,2401105.0,0.0,2401105.0,0.0
260,ARR; WRC,22_05,305016.0,0.0,2706121.0,0.0,2706121.0,0.0
261,ARR; WRC,22_06,830.0,0.0,2706951.0,0.0,2706951.0,0.0
262,ARR; WRC,22_07,300.0,0.0,2707251.0,0.0,2707251.0,0.0
263,ARR; WRC,22_09,11186.0,0.0,2718437.0,0.0,2718437.0,0.0
264,ARR; WRC,22_10,3188651.0,0.0,5907088.0,0.0,5907088.0,0.0
265,ARR; WRC,23_03,44290.0,0.0,5951378.0,0.0,5951378.0,0.0
266,ARR; WRC,23_06,0.0,66006.0,5951378.0,66006.0,5885372.0,0.011090876768371963
267,ARR; WRC,23_07,0.0,14682.0,5951378.0,80688.0,5870690.0,0.013557868446601779
268,Construction / Manufacturing,09_11,101350.0,0.0,101350.0,0.0,101350.0,0.0
269,Construction / Manufacturing,09_12,19502.0,0.0,120852.0,0.0,120852.0,0.0
270,Construction / Manufacturing,10_03,55187.0,0.0,176039.0,0.0,176039.0,0.0
271,Construction / Manufacturing,10_05,230709.0,0.0,406748.0,0.0,406748.0,0.0
272,Construction / Manufacturing,10_06,50000.0,0.0,456748.0,0.0,456748.0,0.0
273,Construction / Manufacturing,10_09,130000.0,0.0,586748.0,0.0,586748.0,0.0
274,Construction / Manufacturing,10_11,63154.0,0.0,649902.0,0.0,649902.0,0.0
275,Construction / Manufacturing,10_12,73000.0,0.0,722902.0,0.0,722902.0,0.0
276,Construction / Manufacturing,11_02,95181.0,0.0,818083.0,0.0,818083.0,0.0
277,Construction / Manufacturing,11_03,37619.0,0.0,855702.0,0.0,855702.0,0.0
278,Construction / Manufacturing,11_05,15000.0,0.0,870702.0,0.0,870702.0,0.0
279,Construction / Manufacturing,11_06,235892.0,0.0,1106594.0,0.0,1106594.0,0.0
280,Construction / Manufacturing,11_07,61068.0,0.0,1167662.0,0.0,1167662.0,0.0
281,Construction / Manufacturing,11_09,439000.0,0.0,1606662.0,0.0,1606662.0,0.0
282,Construction / Manufacturing,11_10,20000.0,0.0,1626662.0,0.0,1626662.0,0.0
283,Construction / Manufacturing,11_11,502999.0,0.0,2129661.0,0.0,2129661.0,0.0
284,Construction / Manufacturing,11_12,297289.0,0.0,2426950.0,0.0,2426950.0,0.0
285,Construction / Manufacturing,12_02,50000.0,0.0,2476950.0,0.0,2476950.0,0.0
286,Construction / Manufacturing,12_04,219292.0,0.0,2696242.0,0.0,2696242.0,0.0
287,Construction / Manufacturing,12_05,820000.0,0.0,3516242.0,0.0,3516242.0,0.0
288,Construction / Manufacturing,12_06,272341.0,0.0,3788583.0,0.0,3788583.0,0.0
289,Construction / Manufacturing,12_07,270958.0,0.0,4059541.0,0.0,4059541.0,0.0
290,Construction / Manufacturing,12_08,350000.0,0.0,4409541.0,0.0,4409541.0,0.0
291,Construction / Manufacturing,12_09,100000.0,0.0,4509541.0,0.0,4509541.0,0.0
292,Construction / Manufacturing,12_10,35000.0,0.0,4544541.0,0.0,4544541.0,0.0
293,Construction / Manufacturing,12_11,262198.0,0.0,4806739.0,0.0,4806739.0,0.0
294,Construction / Manufacturing,13_03,224663.0,0.0,5031402.0,0.0,5031402.0,0.0
295,Construction / Manufacturing,13_04,587977.0,0.0,5619379.0,0.0,5619379.0,0.0
296,Construction / Manufacturing,13_07,30043.0,0.0,5649422.0,0.0,5649422.0,0.0
297,Construction / Manufacturing,13_08,12500.0,0.0,5661922.0,0.0,5661922.0,0.0
298,Construction / Manufacturing,13_09,119655.0,0.0,5781577.0,0.0,5781577.0,0.0
299,Construction / Manufacturing,13_10,122000.0,0.0,5903577.0,0.0,5903577.0,0.0
300,Construction / Manufacturing,13_11,5034.0,0.0,5908611.0,0.0,5908611.0,0.0
301,Construction / Manufacturing,14_04,65294.0,0.0,5973905.0,0.0,5973905.0,0.0
302,Construction / Manufacturing,14_06,25000.0,0.0,5998905.0,0.0,5998905.0,0.0
303,Construction / Manufacturing,14_09,154875.0,0.0,6153780.0,0.0,6153780.0,0.0
304,Construction / Manufacturing,14_12,16000.0,0.0,6169780.0,0.0,6169780.0,0.0
305,Construction / Manufacturing,15_01,450000.0,0.0,6619780.0,0.0,6619780.0,0.0
306,Construction / Manufacturing,15_03,76000.0,0.0,6695780.0,0.0,6695780.0,0.0
307,Construction / Manufacturing,15_05,545648.0,0.0,7241428.0,0.0,7241428.0,0.0
308,Construction / Manufacturing,15_06,105839.0,0.0,7347267.0,0.0,7347267.0,0.0
309,Construction / Manufacturing,15_08,3224.0,0.0,7350491.0,0.0,7350491.0,0.0
310,Construction / Manufacturing,15_12,61416.0,0.0,7411907.0,0.0,7411907.0,0.0
311,Construction / Manufacturing,16_01,18000.0,0.0,7429907.0,0.0,7429907.0,0.0
312,Construction / Manufacturing,16_02,61818.0,0.0,7491725.0,0.0,7491725.0,0.0
313,Construction / Manufacturing,16_03,101500.0,0.0,7593225.0,0.0,7593225.0,0.0
314,Construction / Manufacturing,16_04,145228.0,0.0,7738453.0,0.0,7738453.0,0.0
315,Construction / Manufacturing,16_05,20000.0,0.0,7758453.0,0.0,7758453.0,0.0
316,Construction / Manufacturing,16_07,134292.0,0.0,7892745.0,0.0,7892745.0,0.0
317,Construction / Manufacturing,16_10,18329.0,0.0,7911074.0,0.0,7911074.0,0.0
318,Construction / Manufacturing,16_11,119960.0,0.0,8031034.0,0.0,8031034.0,0.0
319,Construction / Manufacturing,16_12,1519106.0,0.0,9550140.0,0.0,9550140.0,0.0
320,Construction / Manufacturing,17_01,15000.0,0.0,9565140.0,0.0,9565140.0,0.0
321,Construction / Manufacturing,17_02,127004.0,0.0,9692144.0,0.0,9692144.0,0.0
322,Construction / Manufacturing,17_06,237272.0,0.0,9929416.0,0.0,9929416.0,0.0
323,Construction / Manufacturing,17_07,125330.0,0.0,10054746.0,0.0,10054746.0,0.0
324,Construction / Manufacturing,17_08,216384.0,0.0,10271130.0,0.0,10271130.0,0.0
325,Construction / Manufacturing,17_10,93000.0,0.0,10364130.0,0.0,10364130.0,0.0
326,Construction / Manufacturing,17_11,80000.0,0.0,10444130.0,0.0,10444130.0,0.0
327,Construction / Manufacturing,17_12,3431.0,0.0,10447561.0,0.0,10447561.0,0.0
328,Construction / Manufacturing,18_02,186115.0,0.0,10633676.0,0.0,10633676.0,0.0
329,Construction / Manufacturing,18_03,16124.0,0.0,10649800.0,0.0,10649800.0,0.0
330,Construction / Manufacturing,18_04,44000.0,0.0,10693800.0,0.0,10693800.0,0.0
331,Construction / Manufacturing,18_05,3431.0,0.0,10697231.0,0.0,10697231.0,0.0
332,Construction / Manufacturing,18_07,515135.0,0.0,11212366.0,0.0,11212366.0,0.0
333,Construction / Manufacturing,18_09,389186.0,0.0,11601552.0,0.0,11601552.0,0.0
334,Construction / Manufacturing,18_11,130000.0,0.0,11731552.0,0.0,11731552.0,0.0
335,Construction / Manufacturing,18_12,2966.0,0.0,11734518.0,0.0,11734518.0,0.0
336,Construction / Manufacturing,19_02,10000.0,0.0,11744518.0,0.0,11744518.0,0.0
337,Construction / Manufacturing,19_03,108903.0,0.0,11853421.0,0.0,11853421.0,0.0
338,Construction / Manufacturing,19_05,400000.0,0.0,12253421.0,0.0,12253421.0,0.0
339,Construction / Manufacturing,19_07,100000.0,0.0,12353421.0,0.0,12353421.0,0.0
340,Construction / Manufacturing,19_08,88505.0,0.0,12441926.0,0.0,12441926.0,0.0
341,Construction / Manufacturing,19_09,300000.0,0.0,12741926.0,0.0,12741926.0,0.0
342,Construction / Manufacturing,19_10,25341.0,0.0,12767267.0,0.0,12767267.0,0.0
343,Construction / Manufacturing,19_12,75000.0,0.0,12842267.0,0.0,12842267.0,0.0
344,Construction / Manufacturing,20_01,30000.0,0.0,12872267.0,0.0,12872267.0,0.0
345,Construction / Manufacturing,20_02,68161.0,0.0,12940428.0,0.0,12940428.0,0.0
346,Construction / Manufacturing,20_06,26480.0,0.0,12966908.0,0.0,12966908.0,0.0
347,Construction / Manufacturing,20_07,601800.0,0.0,13568708.0,0.0,13568708.0,0.0
348,Construction / Manufacturing,20_08,181848.0,0.0,13750556.0,0.0,13750556.0,0.0
349,Construction / Manufacturing,20_10,385000.0,0.0,14135556.0,0.0,14135556.0,0.0
350,Construction / Manufacturing,20_11,1022128.0,0.0,15157684.0,0.0,15157684.0,0.0
351,Construction / Manufacturing,20_12,857984.0,0.0,16015668.0,0.0,16015668.0,0.0
352,Construction / Manufacturing,21_01,194009.0,0.0,16209677.0,0.0,16209677.0,0.0
353,Construction / Manufacturing,21_02,569603.0,0.0,16779280.0,0.0,16779280.0,0.0
354,Construction / Manufacturing,21_03,100000.0,0.0,16879280.0,0.0,16879280.0,0.0
355,Construction / Manufacturing,21_04,36008.0,0.0,16915288.0,0.0,16915288.0,0.0
356,Construction / Manufacturing,21_05,439037.0,0.0,17354325.0,0.0,17354325.0,0.0
357,Construction / Manufacturing,21_06,431670.0,0.0,17785995.0,0.0,17785995.0,0.0
358,Construction / Manufacturing,21_07,305607.0,0.0,18091602.0,0.0,18091602.0,0.0
359,Construction / Manufacturing,21_08,866421.0,0.0,18958023.0,0.0,18958023.0,0.0
360,Construction / Manufacturing,21_09,219078.0,0.0,19177101.0,0.0,19177101.0,0.0
361,Construction / Manufacturing,21_10,33188.0,0.0,19210289.0,0.0,19210289.0,0.0
362,Construction / Manufacturing,21_11,122.0,0.0,19210411.0,0.0,19210411.0,0.0
363,Construction / Manufacturing,21_12,248497.0,0.0,19458908.0,0.0,19458908.0,0.0
364,Construction / Manufacturing,22_01,374673.0,0.0,19833581.0,0.0,19833581.0,0.0
365,Construction / Manufacturing,22_02,444754.0,0.0,20278335.0,0.0,20278335.0,0.0
366,Construction / Manufacturing,22_03,1500.0,0.0,20279835.0,0.0,20279835.0,0.0
367,Construction / Manufacturing,22_06,17677.0,0.0,20297512.0,0.0,20297512.0,0.0
368,Construction / Manufacturing,22_07,3979.0,0.0,20301491.0,0.0,20301491.0,0.0
369,Construction / Manufacturing,22_08,89548.0,0.0,20391039.0,0.0,20391039.0,0.0
370,Construction / Manufacturing,22_11,20000.0,0.0,20411039.0,0.0,20411039.0,0.0
371,Construction / Manufacturing,23_03,14581.0,0.0,20425620.0,0.0,20425620.0,0.0
372,Construction / Manufacturing,23_04,8810.0,0.0,20434430.0,0.0,20434430.0,0.0
373,Construction / Manufacturing,23_06,666427.0,762.0,21100857.0,762.0,21100095.0,3.611227733546557e-05
374,Construction / Manufacturing,23_07,0.0,5639.0,21100857.0,6401.0,21094456.0,0.0003033526079059253
375,Cookstoves,09_11,132600.0,0.0,132600.0,0.0,132600.0,0.0
376,Cookstoves,10_02,262311.0,0.0,394911.0,0.0,394911.0,0.0
377,Cookstoves,10_08,258631.0,0.0,653542.0,0.0,653542.0,0.0
378,Cookstoves,11_07,344181.0,0.0,997723.0,0.0,997723.0,0.0
379,Cookstoves,12_06,349352.0,0.0,1347075.0,0.0,1347075.0,0.0
380,Cookstoves,12_12,41750.0,0.0,1388825.0,0.0,1388825.0,0.0
381,Cookstoves,13_06,373769.0,0.0,1762594.0,0.0,1762594.0,0.0
382,Cookstoves,13_09,27497.0,0.0,1790091.0,0.0,1790091.0,0.0
383,Cookstoves,14_02,170345.0,0.0,1960436.0,0.0,1960436.0,0.0
384,Cookstoves,14_03,116665.0,0.0,2077101.0,0.0,2077101.0,0.0
385,Cookstoves,14_10,22059.0,0.0,2099160.0,0.0,2099160.0,0.0
386,Cookstoves,15_08,8204.0,0.0,2107364.0,0.0,2107364.0,0.0
387,Cookstoves,15_12,41824.0,0.0,2149188.0,0.0,2149188.0,0.0
388,Cookstoves,16_05,7920.0,0.0,2157108.0,0.0,2157108.0,0.0
389,Cookstoves,16_09,7331.0,0.0,2164439.0,0.0,2164439.0,0.0
390,Cookstoves,17_05,51247.0,0.0,2215686.0,0.0,2215686.0,0.0
391,Cookstoves,17_07,41613.0,0.0,2257299.0,0.0,2257299.0,0.0
392,Cookstoves,17_11,42575.0,0.0,2299874.0,0.0,2299874.0,0.0
393,Cookstoves,17_12,33416.0,0.0,2333290.0,0.0,2333290.0,0.0
394,Cookstoves,18_11,30805.0,0.0,2364095.0,0.0,2364095.0,0.0
395,Cookstoves,18_12,53319.0,0.0,2417414.0,0.0,2417414.0,0.0
396,Cookstoves,19_04,267181.0,0.0,2684595.0,0.0,2684595.0,0.0
397,Cookstoves,19_11,230594.0,0.0,2915189.0,0.0,2915189.0,0.0
398,Cookstoves,19_12,2633.0,0.0,2917822.0,0.0,2917822.0,0.0
399,Cookstoves,20_01,91951.0,0.0,3009773.0,0.0,3009773.0,0.0
400,Cookstoves,20_02,120000.0,0.0,3129773.0,0.0,3129773.0,0.0
401,Cookstoves,20_03,315873.0,0.0,3445646.0,0.0,3445646.0,0.0
402,Cookstoves,20_05,30393.0,0.0,3476039.0,0.0,3476039.0,0.0
403,Cookstoves,20_09,145735.0,0.0,3621774.0,0.0,3621774.0,0.0
404,Cookstoves,20_11,4529.0,0.0,3626303.0,0.0,3626303.0,0.0
405,Cookstoves,20_12,500.0,0.0,3626803.0,0.0,3626803.0,0.0
406,Cookstoves,21_02,254115.0,0.0,3880918.0,0.0,3880918.0,0.0
407,Cookstoves,21_03,10898.0,0.0,3891816.0,0.0,3891816.0,0.0
408,Cookstoves,21_04,975.0,0.0,3892791.0,0.0,3892791.0,0.0
409,Cookstoves,21_09,337284.0,0.0,4230075.0,0.0,4230075.0,0.0
410,Cookstoves,21_11,121421.0,0.0,4351496.0,0.0,4351496.0,0.0
411,Cookstoves,21_12,56361.0,0.0,4407857.0,0.0,4407857.0,0.0
412,Cookstoves,22_02,312353.0,0.0,4720210.0,0.0,4720210.0,0.0
413,Cookstoves,22_03,159752.0,0.0,4879962.0,0.0,4879962.0,0.0
414,Cookstoves,22_04,172946.0,0.0,5052908.0,0.0,5052908.0,0.0
415,Cookstoves,22_05,258931.0,0.0,5311839.0,0.0,5311839.0,0.0
416,Cookstoves,22_06,750276.0,0.0,6062115.0,0.0,6062115.0,0.0
417,Cookstoves,22_07,8265.0,0.0,6070380.0,0.0,6070380.0,0.0
418,Cookstoves,22_08,69502.0,0.0,6139882.0,0.0,6139882.0,0.0
419,Cookstoves,22_09,348416.0,0.0,6488298.0,0.0,6488298.0,0.0
420,Cookstoves,22_10,826927.0,0.0,7315225.0,0.0,7315225.0,0.0
421,Cookstoves,22_11,890107.0,0.0,8205332.0,0.0,8205332.0,0.0
422,Cookstoves,22_12,3508506.0,0.0,11713838.0,0.0,11713838.0,0.0
423,Cookstoves,23_01,316570.0,0.0,12030408.0,0.0,12030408.0,0.0
424,Cookstoves,23_02,3629247.0,0.0,15659655.0,0.0,15659655.0,0.0
425,Cookstoves,23_03,341685.0,0.0,16001340.0,0.0,16001340.0,0.0
426,Cookstoves,23_04,1390992.0,0.0,17392332.0,0.0,17392332.0,0.0
427,Cookstoves,23_05,1561192.0,0.0,18953524.0,0.0,18953524.0,0.0
428,Cookstoves,23_06,2171629.0,160249.0,21125153.0,160249.0,20964904.0,0.007585696539097255
429,Cookstoves,23_07,1309149.0,920692.0,22434302.0,1080941.0,21353361.0,0.04818251087107591
430,Fugitive Emiss.,09_07,167647.0,0.0,167647.0,0.0,167647.0,0.0
431,Fugitive Emiss.,09_08,35582.0,0.0,203229.0,0.0,203229.0,0.0
432,Fugitive Emiss.,09_10,51080.0,0.0,254309.0,0.0,254309.0,0.0
433,Fugitive Emiss.,09_11,128574.0,0.0,382883.0,0.0,382883.0,0.0
434,Fugitive Emiss.,09_12,2580754.0,0.0,2963637.0,0.0,2963637.0,0.0
435,Fugitive Emiss.,10_01,141676.0,0.0,3105313.0,0.0,3105313.0,0.0
436,Fugitive Emiss.,10_06,3722589.0,0.0,6827902.0,0.0,6827902.0,0.0
437,Fugitive Emiss.,10_09,46956.0,0.0,6874858.0,0.0,6874858.0,0.0
438,Fugitive Emiss.,10_10,6000.0,0.0,6880858.0,0.0,6880858.0,0.0
439,Fugitive Emiss.,10_12,49500.0,0.0,6930358.0,0.0,6930358.0,0.0
440,Fugitive Emiss.,11_01,102948.0,0.0,7033306.0,0.0,7033306.0,0.0
441,Fugitive Emiss.,11_10,20940.0,0.0,7054246.0,0.0,7054246.0,0.0
442,Fugitive Emiss.,11_11,192715.0,0.0,7246961.0,0.0,7246961.0,0.0
443,Fugitive Emiss.,11_12,220481.0,0.0,7467442.0,0.0,7467442.0,0.0
444,Fugitive Emiss.,12_06,49962.0,0.0,7517404.0,0.0,7517404.0,0.0
445,Fugitive Emiss.,12_08,19243.0,0.0,7536647.0,0.0,7536647.0,0.0
446,Fugitive Emiss.,12_12,56111.0,0.0,7592758.0,0.0,7592758.0,0.0
447,Fugitive Emiss.,13_04,75214.0,0.0,7667972.0,0.0,7667972.0,0.0
448,Fugitive Emiss.,13_06,3751.0,0.0,7671723.0,0.0,7671723.0,0.0
449,Fugitive Emiss.,13_09,18777.0,0.0,7690500.0,0.0,7690500.0,0.0
450,Fugitive Emiss.,13_11,15427.0,0.0,7705927.0,0.0,7705927.0,0.0
451,Fugitive Emiss.,14_03,3747.0,0.0,7709674.0,0.0,7709674.0,0.0
452,Fugitive Emiss.,14_04,28854.0,0.0,7738528.0,0.0,7738528.0,0.0
453,Fugitive Emiss.,14_06,47691.0,0.0,7786219.0,0.0,7786219.0,0.0
454,Fugitive Emiss.,14_10,84460.0,0.0,7870679.0,0.0,7870679.0,0.0
455,Fugitive Emiss.,14_12,25927.0,0.0,7896606.0,0.0,7896606.0,0.0
456,Fugitive Emiss.,15_06,30519.0,0.0,7927125.0,0.0,7927125.0,0.0
457,Fugitive Emiss.,15_07,26626.0,0.0,7953751.0,0.0,7953751.0,0.0
458,Fugitive Emiss.,15_12,24729.0,0.0,7978480.0,0.0,7978480.0,0.0
459,Fugitive Emiss.,16_02,3290.0,0.0,7981770.0,0.0,7981770.0,0.0
460,Fugitive Emiss.,16_07,23783.0,0.0,8005553.0,0.0,8005553.0,0.0
461,Fugitive Emiss.,16_11,63023.0,0.0,8068576.0,0.0,8068576.0,0.0
462,Fugitive Emiss.,17_06,42549.0,0.0,8111125.0,0.0,8111125.0,0.0
463,Fugitive Emiss.,17_08,434379.0,0.0,8545504.0,0.0,8545504.0,0.0
464,Fugitive Emiss.,18_04,46816.0,0.0,8592320.0,0.0,8592320.0,0.0
465,Fugitive Emiss.,19_07,36829.0,0.0,8629149.0,0.0,8629149.0,0.0
466,Fugitive Emiss.,21_03,10000.0,0.0,8639149.0,0.0,8639149.0,0.0
467,Fugitive Emiss.,21_04,990000.0,0.0,9629149.0,0.0,9629149.0,0.0
468,Fugitive Emiss.,21_05,2620338.0,0.0,12249487.0,0.0,12249487.0,0.0
469,Fugitive Emiss.,21_06,423657.0,0.0,12673144.0,0.0,12673144.0,0.0
470,Fugitive Emiss.,21_07,224553.0,0.0,12897697.0,0.0,12897697.0,0.0
471,Fugitive Emiss.,21_12,1500001.0,0.0,14397698.0,0.0,14397698.0,0.0
472,Fugitive Emiss.,22_02,1500000.0,0.0,15897698.0,0.0,15897698.0,0.0
473,Fugitive Emiss.,22_04,484655.0,0.0,16382353.0,0.0,16382353.0,0.0
474,Fugitive Emiss.,22_05,581848.0,0.0,16964201.0,0.0,16964201.0,0.0
475,Fugitive Emiss.,22_08,1025000.0,0.0,17989201.0,0.0,17989201.0,0.0
476,Fugitive Emiss.,22_09,491883.0,0.0,18481084.0,0.0,18481084.0,0.0
477,Fugitive Emiss.,22_11,320000.0,0.0,18801084.0,0.0,18801084.0,0.0
478,Fugitive Emiss.,22_12,13045357.0,0.0,31846441.0,0.0,31846441.0,0.0
479,Fugitive Emiss.,23_02,10000.0,0.0,31856441.0,0.0,31856441.0,0.0
480,Fugitive Emiss.,23_04,100.0,0.0,31856541.0,0.0,31856541.0,0.0
481,Fugitive Emiss.,23_06,1026861.0,20019.0,32883402.0,20019.0,32863383.0,0.0006087873754668084
482,Fugitive Emiss.,23_07,0.0,39813.0,32883402.0,59832.0,32823570.0,0.0018195197686662712
483,Hydro,09_04,67898.0,0.0,67898.0,0.0,67898.0,0.0
484,Hydro,09_05,278142.0,0.0,346040.0,0.0,346040.0,0.0
485,Hydro,09_06,409641.0,0.0,755681.0,0.0,755681.0,0.0
486,Hydro,09_07,302493.0,0.0,1058174.0,0.0,1058174.0,0.0
487,Hydro,09_08,170949.0,0.0,1229123.0,0.0,1229123.0,0.0
488,Hydro,09_09,287460.0,0.0,1516583.0,0.0,1516583.0,0.0
489,Hydro,09_10,71122.0,0.0,1587705.0,0.0,1587705.0,0.0
490,Hydro,09_11,599902.0,0.0,2187607.0,0.0,2187607.0,0.0
491,Hydro,09_12,95215.0,0.0,2282822.0,0.0,2282822.0,0.0
492,Hydro,10_01,1063451.0,0.0,3346273.0,0.0,3346273.0,0.0
493,Hydro,10_02,98258.0,0.0,3444531.0,0.0,3444531.0,0.0
494,Hydro,10_03,188527.0,0.0,3633058.0,0.0,3633058.0,0.0
495,Hydro,10_04,94112.0,0.0,3727170.0,0.0,3727170.0,0.0
496,Hydro,10_05,318275.0,0.0,4045445.0,0.0,4045445.0,0.0
497,Hydro,10_06,323045.0,0.0,4368490.0,0.0,4368490.0,0.0
498,Hydro,10_07,271458.0,0.0,4639948.0,0.0,4639948.0,0.0
499,Hydro,10_08,114941.0,0.0,4754889.0,0.0,4754889.0,0.0
500,Hydro,10_09,66974.0,0.0,4821863.0,0.0,4821863.0,0.0
501,Hydro,10_10,50000.0,0.0,4871863.0,0.0,4871863.0,0.0
502,Hydro,10_11,597067.0,0.0,5468930.0,0.0,5468930.0,0.0
503,Hydro,10_12,1237640.0,0.0,6706570.0,0.0,6706570.0,0.0
504,Hydro,11_01,364453.0,0.0,7071023.0,0.0,7071023.0,0.0
505,Hydro,11_02,101707.0,0.0,7172730.0,0.0,7172730.0,0.0
506,Hydro,11_03,175778.0,0.0,7348508.0,0.0,7348508.0,0.0
507,Hydro,11_04,48111.0,0.0,7396619.0,0.0,7396619.0,0.0
508,Hydro,11_05,151851.0,0.0,7548470.0,0.0,7548470.0,0.0
509,Hydro,11_06,255878.0,0.0,7804348.0,0.0,7804348.0,0.0
510,Hydro,11_07,241369.0,0.0,8045717.0,0.0,8045717.0,0.0
511,Hydro,11_08,170300.0,0.0,8216017.0,0.0,8216017.0,0.0
512,Hydro,11_09,760338.0,0.0,8976355.0,0.0,8976355.0,0.0
513,Hydro,11_10,364343.0,0.0,9340698.0,0.0,9340698.0,0.0
514,Hydro,11_11,1627770.0,0.0,10968468.0,0.0,10968468.0,0.0
515,Hydro,11_12,506982.0,0.0,11475450.0,0.0,11475450.0,0.0
516,Hydro,12_01,1481507.0,0.0,12956957.0,0.0,12956957.0,0.0
517,Hydro,12_02,480260.0,0.0,13437217.0,0.0,13437217.0,0.0
518,Hydro,12_03,1046417.0,0.0,14483634.0,0.0,14483634.0,0.0
519,Hydro,12_04,201607.0,0.0,14685241.0,0.0,14685241.0,0.0
520,Hydro,12_05,878727.0,0.0,15563968.0,0.0,15563968.0,0.0
521,Hydro,12_06,528514.0,0.0,16092482.0,0.0,16092482.0,0.0
522,Hydro,12_07,2475622.0,0.0,18568104.0,0.0,18568104.0,0.0
523,Hydro,12_08,1269702.0,0.0,19837806.0,0.0,19837806.0,0.0
524,Hydro,12_09,684272.0,0.0,20522078.0,0.0,20522078.0,0.0
525,Hydro,12_10,1152435.0,0.0,21674513.0,0.0,21674513.0,0.0
526,Hydro,12_11,616411.0,0.0,22290924.0,0.0,22290924.0,0.0
527,Hydro,12_12,657705.0,0.0,22948629.0,0.0,22948629.0,0.0
528,Hydro,13_01,1458603.0,0.0,24407232.0,0.0,24407232.0,0.0
529,Hydro,13_02,337071.0,0.0,24744303.0,0.0,24744303.0,0.0
530,Hydro,13_03,420986.0,0.0,25165289.0,0.0,25165289.0,0.0
531,Hydro,13_04,301002.0,0.0,25466291.0,0.0,25466291.0,0.0
532,Hydro,13_05,1345998.0,0.0,26812289.0,0.0,26812289.0,0.0
533,Hydro,13_06,268306.0,0.0,27080595.0,0.0,27080595.0,0.0
534,Hydro,13_07,890450.0,0.0,27971045.0,0.0,27971045.0,0.0
535,Hydro,13_08,94489.0,0.0,28065534.0,0.0,28065534.0,0.0
536,Hydro,13_09,229955.0,0.0,28295489.0,0.0,28295489.0,0.0
537,Hydro,13_10,132770.0,0.0,28428259.0,0.0,28428259.0,0.0
538,Hydro,13_11,85458.0,0.0,28513717.0,0.0,28513717.0,0.0
539,Hydro,13_12,232849.0,0.0,28746566.0,0.0,28746566.0,0.0
540,Hydro,14_01,203080.0,0.0,28949646.0,0.0,28949646.0,0.0
541,Hydro,14_02,544544.0,0.0,29494190.0,0.0,29494190.0,0.0
542,Hydro,14_03,311562.0,0.0,29805752.0,0.0,29805752.0,0.0
543,Hydro,14_04,224624.0,0.0,30030376.0,0.0,30030376.0,0.0
544,Hydro,14_05,242448.0,0.0,30272824.0,0.0,30272824.0,0.0
545,Hydro,14_06,100000.0,0.0,30372824.0,0.0,30372824.0,0.0
546,Hydro,14_07,108573.0,0.0,30481397.0,0.0,30481397.0,0.0
547,Hydro,14_08,11300.0,0.0,30492697.0,0.0,30492697.0,0.0
548,Hydro,14_09,216516.0,0.0,30709213.0,0.0,30709213.0,0.0
549,Hydro,14_10,304842.0,0.0,31014055.0,0.0,31014055.0,0.0
550,Hydro,14_11,155291.0,0.0,31169346.0,0.0,31169346.0,0.0
551,Hydro,14_12,73725.0,0.0,31243071.0,0.0,31243071.0,0.0
552,Hydro,15_01,10136.0,0.0,31253207.0,0.0,31253207.0,0.0
553,Hydro,15_02,5000.0,0.0,31258207.0,0.0,31258207.0,0.0
554,Hydro,15_03,31199.0,0.0,31289406.0,0.0,31289406.0,0.0
555,Hydro,15_04,35000.0,0.0,31324406.0,0.0,31324406.0,0.0
556,Hydro,15_05,39100.0,0.0,31363506.0,0.0,31363506.0,0.0
557,Hydro,15_06,59452.0,0.0,31422958.0,0.0,31422958.0,0.0
558,Hydro,15_07,246452.0,0.0,31669410.0,0.0,31669410.0,0.0
559,Hydro,15_08,27671.0,0.0,31697081.0,0.0,31697081.0,0.0
560,Hydro,15_09,208738.0,0.0,31905819.0,0.0,31905819.0,0.0
561,Hydro,15_10,23844.0,0.0,31929663.0,0.0,31929663.0,0.0
562,Hydro,15_11,872439.0,0.0,32802102.0,0.0,32802102.0,0.0
563,Hydro,15_12,209047.0,0.0,33011149.0,0.0,33011149.0,0.0
564,Hydro,16_01,13092.0,0.0,33024241.0,0.0,33024241.0,0.0
565,Hydro,16_02,24800.0,0.0,33049041.0,0.0,33049041.0,0.0
566,Hydro,16_03,30000.0,0.0,33079041.0,0.0,33079041.0,0.0
567,Hydro,16_04,150335.0,0.0,33229376.0,0.0,33229376.0,0.0
568,Hydro,16_05,355837.0,0.0,33585213.0,0.0,33585213.0,0.0
569,Hydro,16_06,65000.0,0.0,33650213.0,0.0,33650213.0,0.0
570,Hydro,16_07,44632.0,0.0,33694845.0,0.0,33694845.0,0.0
571,Hydro,16_08,14012.0,0.0,33708857.0,0.0,33708857.0,0.0
572,Hydro,16_10,5250.0,0.0,33714107.0,0.0,33714107.0,0.0
573,Hydro,16_11,197061.0,0.0,33911168.0,0.0,33911168.0,0.0
574,Hydro,16_12,230000.0,0.0,34141168.0,0.0,34141168.0,0.0
575,Hydro,17_01,160000.0,0.0,34301168.0,0.0,34301168.0,0.0
576,Hydro,17_02,70000.0,0.0,34371168.0,0.0,34371168.0,0.0
577,Hydro,17_03,91147.0,0.0,34462315.0,0.0,34462315.0,0.0
578,Hydro,17_04,155672.0,0.0,34617987.0,0.0,34617987.0,0.0
579,Hydro,17_05,53186.0,0.0,34671173.0,0.0,34671173.0,0.0
580,Hydro,17_06,978298.0,0.0,35649471.0,0.0,35649471.0,0.0
581,Hydro,17_07,179693.0,0.0,35829164.0,0.0,35829164.0,0.0
582,Hydro,17_08,122692.0,0.0,35951856.0,0.0,35951856.0,0.0
583,Hydro,17_09,718223.0,0.0,36670079.0,0.0,36670079.0,0.0
584,Hydro,17_10,60000.0,0.0,36730079.0,0.0,36730079.0,0.0
585,Hydro,17_11,630398.0,0.0,37360477.0,0.0,37360477.0,0.0
586,Hydro,17_12,9008.0,0.0,37369485.0,0.0,37369485.0,0.0
587,Hydro,18_01,75000.0,0.0,37444485.0,0.0,37444485.0,0.0
588,Hydro,18_03,313860.0,0.0,37758345.0,0.0,37758345.0,0.0
589,Hydro,18_04,229739.0,0.0,37988084.0,0.0,37988084.0,0.0
590,Hydro,18_05,78363.0,0.0,38066447.0,0.0,38066447.0,0.0
591,Hydro,18_06,673885.0,0.0,38740332.0,0.0,38740332.0,0.0
592,Hydro,18_07,589113.0,0.0,39329445.0,0.0,39329445.0,0.0
593,Hydro,18_08,25000.0,0.0,39354445.0,0.0,39354445.0,0.0
594,Hydro,18_09,166965.0,0.0,39521410.0,0.0,39521410.0,0.0
595,Hydro,18_10,741637.0,0.0,40263047.0,0.0,40263047.0,0.0
596,Hydro,18_11,155994.0,0.0,40419041.0,0.0,40419041.0,0.0
597,Hydro,18_12,686195.0,0.0,41105236.0,0.0,41105236.0,0.0
598,Hydro,19_01,1511000.0,0.0,42616236.0,0.0,42616236.0,0.0
599,Hydro,19_02,80000.0,0.0,42696236.0,0.0,42696236.0,0.0
600,Hydro,19_03,59152.0,0.0,42755388.0,0.0,42755388.0,0.0
601,Hydro,19_04,682310.0,0.0,43437698.0,0.0,43437698.0,0.0
602,Hydro,19_05,101918.0,0.0,43539616.0,0.0,43539616.0,0.0
603,Hydro,19_06,150559.0,0.0,43690175.0,0.0,43690175.0,0.0
604,Hydro,19_07,350070.0,0.0,44040245.0,0.0,44040245.0,0.0
605,Hydro,19_08,410918.0,0.0,44451163.0,0.0,44451163.0,0.0
606,Hydro,19_09,742000.0,0.0,45193163.0,0.0,45193163.0,0.0
607,Hydro,19_10,388844.0,0.0,45582007.0,0.0,45582007.0,0.0
608,Hydro,19_11,407941.0,0.0,45989948.0,0.0,45989948.0,0.0
609,Hydro,19_12,1591542.0,0.0,47581490.0,0.0,47581490.0,0.0
610,Hydro,20_01,2327214.0,0.0,49908704.0,0.0,49908704.0,0.0
611,Hydro,20_02,1862325.0,0.0,51771029.0,0.0,51771029.0,0.0
612,Hydro,20_03,3151517.0,0.0,54922546.0,0.0,54922546.0,0.0
613,Hydro,20_04,138306.0,0.0,55060852.0,0.0,55060852.0,0.0
614,Hydro,20_05,159313.0,0.0,55220165.0,0.0,55220165.0,0.0
615,Hydro,20_06,1653126.0,0.0,56873291.0,0.0,56873291.0,0.0
616,Hydro,20_07,2877890.0,0.0,59751181.0,0.0,59751181.0,0.0
617,Hydro,20_08,72876.0,0.0,59824057.0,0.0,59824057.0,0.0
618,Hydro,20_09,992313.0,0.0,60816370.0,0.0,60816370.0,0.0
619,Hydro,20_10,1528426.0,0.0,62344796.0,0.0,62344796.0,0.0
620,Hydro,20_11,1237398.0,0.0,63582194.0,0.0,63582194.0,0.0
621,Hydro,20_12,8842876.0,0.0,72425070.0,0.0,72425070.0,0.0
622,Hydro,21_01,1537260.0,0.0,73962330.0,0.0,73962330.0,0.0
623,Hydro,21_02,1961921.0,0.0,75924251.0,0.0,75924251.0,0.0
624,Hydro,21_03,4845932.0,0.0,80770183.0,0.0,80770183.0,0.0
625,Hydro,21_04,8727081.0,0.0,89497264.0,0.0,89497264.0,0.0
626,Hydro,21_05,3827647.0,0.0,93324911.0,0.0,93324911.0,0.0
627,Hydro,21_06,2338432.0,0.0,95663343.0,0.0,95663343.0,0.0
628,Hydro,21_07,2740378.0,0.0,98403721.0,0.0,98403721.0,0.0
629,Hydro,21_08,3380855.0,0.0,101784576.0,0.0,101784576.0,0.0
630,Hydro,21_09,4508834.0,0.0,106293410.0,0.0,106293410.0,0.0
631,Hydro,21_10,4150947.0,0.0,110444357.0,0.0,110444357.0,0.0
632,Hydro,21_11,4113058.0,0.0,114557415.0,0.0,114557415.0,0.0
633,Hydro,21_12,6089454.0,0.0,120646869.0,0.0,120646869.0,0.0
634,Hydro,22_01,3010854.0,0.0,123657723.0,0.0,123657723.0,0.0
635,Hydro,22_02,940868.0,0.0,124598591.0,0.0,124598591.0,0.0
636,Hydro,22_03,2741624.0,0.0,127340215.0,0.0,127340215.0,0.0
637,Hydro,22_04,1419565.0,0.0,128759780.0,0.0,128759780.0,0.0
638,Hydro,22_05,2785466.0,0.0,131545246.0,0.0,131545246.0,0.0
639,Hydro,22_06,5437557.0,0.0,136982803.0,0.0,136982803.0,0.0
640,Hydro,22_07,5321647.0,0.0,142304450.0,0.0,142304450.0,0.0
641,Hydro,22_08,1828233.0,0.0,144132683.0,0.0,144132683.0,0.0
642,Hydro,22_09,642684.0,0.0,144775367.0,0.0,144775367.0,0.0
643,Hydro,22_10,851089.0,0.0,145626456.0,0.0,145626456.0,0.0
644,Hydro,22_11,450388.0,0.0,146076844.0,0.0,146076844.0,0.0
645,Hydro,22_12,2291908.0,0.0,148368752.0,0.0,148368752.0,0.0
646,Hydro,23_01,5204986.0,0.0,153573738.0,0.0,153573738.0,0.0
647,Hydro,23_02,325319.0,0.0,153899057.0,0.0,153899057.0,0.0
648,Hydro,23_03,622594.0,0.0,154521651.0,0.0,154521651.0,0.0
649,Hydro,23_04,293633.0,0.0,154815284.0,0.0,154815284.0,0.0
650,Hydro,23_05,5407899.0,0.0,160223183.0,0.0,160223183.0,0.0
651,Hydro,23_06,997690.0,232018.0,161220873.0,232018.0,160988855.0,0.00143913127179258
652,Hydro,23_07,1057473.0,231332.0,162278346.0,463350.0,161814996.0,0.0028552792866153565
653,IFM,11_05,849016.0,0.0,849016.0,0.0,849016.0,0.0
654,IFM,11_09,605302.0,0.0,1454318.0,0.0,1454318.0,0.0
655,IFM,13_01,144582.0,0.0,1598900.0,0.0,1598900.0,0.0
656,IFM,13_05,22027.0,0.0,1620927.0,0.0,1620927.0,0.0
657,IFM,13_06,170237.0,0.0,1791164.0,0.0,1791164.0,0.0
658,IFM,13_12,170236.0,0.0,1961400.0,0.0,1961400.0,0.0
659,IFM,14_03,32422.0,0.0,1993822.0,0.0,1993822.0,0.0
660,IFM,14_08,24589.0,0.0,2018411.0,0.0,2018411.0,0.0
661,IFM,14_12,15057.0,0.0,2033468.0,0.0,2033468.0,0.0
662,IFM,15_01,160000.0,0.0,2193468.0,0.0,2193468.0,0.0
663,IFM,15_03,14854.0,0.0,2208322.0,0.0,2208322.0,0.0
664,IFM,15_04,145673.0,0.0,2353995.0,0.0,2353995.0,0.0
665,IFM,15_06,5060.0,0.0,2359055.0,0.0,2359055.0,0.0
666,IFM,15_07,26466.0,0.0,2385521.0,0.0,2385521.0,0.0
667,IFM,15_08,27772.0,0.0,2413293.0,0.0,2413293.0,0.0
668,IFM,15_11,95241.0,0.0,2508534.0,0.0,2508534.0,0.0
669,IFM,16_03,9274.0,0.0,2517808.0,0.0,2517808.0,0.0
670,IFM,16_06,32401.0,0.0,2550209.0,0.0,2550209.0,0.0
671,IFM,17_06,100000.0,0.0,2650209.0,0.0,2650209.0,0.0
672,IFM,17_07,12887.0,0.0,2663096.0,0.0,2663096.0,0.0
673,IFM,17_12,30000.0,0.0,2693096.0,0.0,2693096.0,0.0
674,IFM,18_02,4000.0,0.0,2697096.0,0.0,2697096.0,0.0
675,IFM,18_03,75381.0,0.0,2772477.0,0.0,2772477.0,0.0
676,IFM,18_04,10000.0,0.0,2782477.0,0.0,2782477.0,0.0
677,IFM,18_06,380000.0,0.0,3162477.0,0.0,3162477.0,0.0
678,IFM,18_08,11373.0,0.0,3173850.0,0.0,3173850.0,0.0
679,IFM,18_09,10000.0,0.0,3183850.0,0.0,3183850.0,0.0
680,IFM,18_10,32393.0,0.0,3216243.0,0.0,3216243.0,0.0
681,IFM,19_02,288709.0,0.0,3504952.0,0.0,3504952.0,0.0
682,IFM,19_03,265027.0,0.0,3769979.0,0.0,3769979.0,0.0
683,IFM,19_04,45623.0,0.0,3815602.0,0.0,3815602.0,0.0
684,IFM,19_08,33668.0,0.0,3849270.0,0.0,3849270.0,0.0
685,IFM,19_09,12000.0,0.0,3861270.0,0.0,3861270.0,0.0
686,IFM,19_11,131000.0,0.0,3992270.0,0.0,3992270.0,0.0
687,IFM,19_12,188237.0,0.0,4180507.0,0.0,4180507.0,0.0
688,IFM,20_01,12000.0,0.0,4192507.0,0.0,4192507.0,0.0
689,IFM,20_02,40000.0,0.0,4232507.0,0.0,4232507.0,0.0
690,IFM,20_03,546409.0,0.0,4778916.0,0.0,4778916.0,0.0
691,IFM,20_04,200000.0,0.0,4978916.0,0.0,4978916.0,0.0
692,IFM,20_05,1000.0,0.0,4979916.0,0.0,4979916.0,0.0
693,IFM,20_08,82175.0,0.0,5062091.0,0.0,5062091.0,0.0
694,IFM,20_09,15000.0,0.0,5077091.0,0.0,5077091.0,0.0
695,IFM,20_10,251653.0,0.0,5328744.0,0.0,5328744.0,0.0
696,IFM,20_11,167580.0,0.0,5496324.0,0.0,5496324.0,0.0
697,IFM,20_12,599359.0,0.0,6095683.0,0.0,6095683.0,0.0
698,IFM,21_01,20000.0,0.0,6115683.0,0.0,6115683.0,0.0
699,IFM,21_02,314637.0,0.0,6430320.0,0.0,6430320.0,0.0
700,IFM,21_03,1027937.0,0.0,7458257.0,0.0,7458257.0,0.0
701,IFM,21_05,473575.0,0.0,7931832.0,0.0,7931832.0,0.0
702,IFM,21_06,81838.0,0.0,8013670.0,0.0,8013670.0,0.0
703,IFM,21_07,17500.0,0.0,8031170.0,0.0,8031170.0,0.0
704,IFM,21_08,100000.0,0.0,8131170.0,0.0,8131170.0,0.0
705,IFM,21_09,85409.0,0.0,8216579.0,0.0,8216579.0,0.0
706,IFM,21_10,123160.0,0.0,8339739.0,0.0,8339739.0,0.0
707,IFM,21_11,277035.0,0.0,8616774.0,0.0,8616774.0,0.0
708,IFM,22_01,453159.0,0.0,9069933.0,0.0,9069933.0,0.0
709,IFM,22_02,216751.0,0.0,9286684.0,0.0,9286684.0,0.0
710,IFM,22_03,100000.0,0.0,9386684.0,0.0,9386684.0,0.0
711,IFM,22_06,324651.0,0.0,9711335.0,0.0,9711335.0,0.0
712,IFM,22_07,80000.0,0.0,9791335.0,0.0,9791335.0,0.0
713,IFM,22_09,20000.0,0.0,9811335.0,0.0,9811335.0,0.0
714,IFM,22_10,1000.0,0.0,9812335.0,0.0,9812335.0,0.0
715,IFM,23_01,357652.0,0.0,10169987.0,0.0,10169987.0,0.0
716,IFM,23_02,46051.0,0.0,10216038.0,0.0,10216038.0,0.0
717,IFM,23_03,95302.0,0.0,10311340.0,0.0,10311340.0,0.0
718,IFM,23_04,1424513.0,0.0,11735853.0,0.0,11735853.0,0.0
719,IFM,23_05,248866.0,0.0,11984719.0,0.0,11984719.0,0.0
720,IFM,23_06,219943.0,64473.0,12204662.0,64473.0,12140189.0,0.005282653464717007
721,IFM,23_07,0.0,19131.0,12204662.0,83604.0,12121058.0,0.006850169222220165
722,IFM; REDD,14_04,59000.0,0.0,59000.0,0.0,59000.0,0.0
723,IFM; REDD,14_05,14711.0,0.0,73711.0,0.0,73711.0,0.0
724,IFM; REDD,14_08,17600.0,0.0,91311.0,0.0,91311.0,0.0
725,IFM; REDD,14_09,14574.0,0.0,105885.0,0.0,105885.0,0.0
726,IFM; REDD,14_12,8000.0,0.0,113885.0,0.0,113885.0,0.0
727,IFM; REDD,15_03,10000.0,0.0,123885.0,0.0,123885.0,0.0
728,IFM; REDD,15_06,35000.0,0.0,158885.0,0.0,158885.0,0.0
729,IFM; REDD,15_08,100000.0,0.0,258885.0,0.0,258885.0,0.0
730,IFM; REDD,15_09,2000.0,0.0,260885.0,0.0,260885.0,0.0
731,IFM; REDD,15_10,18000.0,0.0,278885.0,0.0,278885.0,0.0
732,IFM; REDD,16_03,17500.0,0.0,296385.0,0.0,296385.0,0.0
733,IFM; REDD,16_05,25000.0,0.0,321385.0,0.0,321385.0,0.0
734,IFM; REDD,16_06,72000.0,0.0,393385.0,0.0,393385.0,0.0
735,IFM; REDD,16_08,1416.0,0.0,394801.0,0.0,394801.0,0.0
736,IFM; REDD,16_09,13500.0,0.0,408301.0,0.0,408301.0,0.0
737,IFM; REDD,16_11,2000.0,0.0,410301.0,0.0,410301.0,0.0
738,IFM; REDD,16_12,400.0,0.0,410701.0,0.0,410701.0,0.0
739,IFM; REDD,17_02,19000.0,0.0,429701.0,0.0,429701.0,0.0
740,IFM; REDD,17_05,7500.0,0.0,437201.0,0.0,437201.0,0.0
741,IFM; REDD,17_07,7780.0,0.0,444981.0,0.0,444981.0,0.0
742,IFM; REDD,17_08,66000.0,0.0,510981.0,0.0,510981.0,0.0
743,IFM; REDD,17_09,14418.0,0.0,525399.0,0.0,525399.0,0.0
744,IFM; REDD,17_10,40000.0,0.0,565399.0,0.0,565399.0,0.0
745,IFM; REDD,18_03,122416.0,0.0,687815.0,0.0,687815.0,0.0
746,IFM; REDD,20_03,83792.0,0.0,771607.0,0.0,771607.0,0.0
747,IFM; REDD,20_04,40950.0,0.0,812557.0,0.0,812557.0,0.0
748,IFM; REDD,20_08,141397.0,0.0,953954.0,0.0,953954.0,0.0
749,IFM; REDD,21_09,1000.0,0.0,954954.0,0.0,954954.0,0.0
750,IFM; REDD,21_12,2341.0,0.0,957295.0,0.0,957295.0,0.0
751,IFM; REDD,22_01,19.0,0.0,957314.0,0.0,957314.0,0.0
752,IFM; REDD,22_06,7534.0,0.0,964848.0,0.0,964848.0,0.0
753,LFG,09_05,27092.0,0.0,27092.0,0.0,27092.0,0.0
754,LFG,09_06,88836.0,0.0,115928.0,0.0,115928.0,0.0
755,LFG,09_09,56520.0,0.0,172448.0,0.0,172448.0,0.0
756,LFG,09_11,137697.0,0.0,310145.0,0.0,310145.0,0.0
757,LFG,09_12,80901.0,0.0,391046.0,0.0,391046.0,0.0
758,LFG,10_01,75196.0,0.0,466242.0,0.0,466242.0,0.0
759,LFG,10_03,70188.0,0.0,536430.0,0.0,536430.0,0.0
760,LFG,10_04,292467.0,0.0,828897.0,0.0,828897.0,0.0
761,LFG,10_06,49668.0,0.0,878565.0,0.0,878565.0,0.0
762,LFG,10_09,19722.0,0.0,898287.0,0.0,898287.0,0.0
763,LFG,10_10,20000.0,0.0,918287.0,0.0,918287.0,0.0
764,LFG,10_11,77823.0,0.0,996110.0,0.0,996110.0,0.0
765,LFG,10_12,25232.0,0.0,1021342.0,0.0,1021342.0,0.0
766,LFG,11_02,104588.0,0.0,1125930.0,0.0,1125930.0,0.0
767,LFG,11_04,64559.0,0.0,1190489.0,0.0,1190489.0,0.0
768,LFG,11_05,170824.0,0.0,1361313.0,0.0,1361313.0,0.0
769,LFG,11_06,23850.0,0.0,1385163.0,0.0,1385163.0,0.0
770,LFG,11_07,74620.0,0.0,1459783.0,0.0,1459783.0,0.0
771,LFG,11_08,35000.0,0.0,1494783.0,0.0,1494783.0,0.0
772,LFG,11_09,33972.0,0.0,1528755.0,0.0,1528755.0,0.0
773,LFG,11_10,12425.0,0.0,1541180.0,0.0,1541180.0,0.0
774,LFG,11_12,210927.0,0.0,1752107.0,0.0,1752107.0,0.0
775,LFG,12_01,31411.0,0.0,1783518.0,0.0,1783518.0,0.0
776,LFG,12_03,124884.0,0.0,1908402.0,0.0,1908402.0,0.0
777,LFG,12_04,5050.0,0.0,1913452.0,0.0,1913452.0,0.0
778,LFG,12_05,29077.0,0.0,1942529.0,0.0,1942529.0,0.0
779,LFG,12_06,80000.0,0.0,2022529.0,0.0,2022529.0,0.0
780,LFG,12_07,27405.0,0.0,2049934.0,0.0,2049934.0,0.0
781,LFG,12_08,18575.0,0.0,2068509.0,0.0,2068509.0,0.0
782,LFG,12_10,365793.0,0.0,2434302.0,0.0,2434302.0,0.0
783,LFG,12_11,5000.0,0.0,2439302.0,0.0,2439302.0,0.0
784,LFG,12_12,547138.0,0.0,2986440.0,0.0,2986440.0,0.0
785,LFG,13_01,34662.0,0.0,3021102.0,0.0,3021102.0,0.0
786,LFG,13_02,154463.0,0.0,3175565.0,0.0,3175565.0,0.0
787,LFG,13_03,23212.0,0.0,3198777.0,0.0,3198777.0,0.0
788,LFG,13_04,63840.0,0.0,3262617.0,0.0,3262617.0,0.0
789,LFG,13_05,36219.0,0.0,3298836.0,0.0,3298836.0,0.0
790,LFG,13_06,290560.0,0.0,3589396.0,0.0,3589396.0,0.0
791,LFG,13_07,9000.0,0.0,3598396.0,0.0,3598396.0,0.0
792,LFG,13_09,15000.0,0.0,3613396.0,0.0,3613396.0,0.0
793,LFG,13_11,79502.0,0.0,3692898.0,0.0,3692898.0,0.0
794,LFG,13_12,198227.0,0.0,3891125.0,0.0,3891125.0,0.0
795,LFG,14_01,24000.0,0.0,3915125.0,0.0,3915125.0,0.0
796,LFG,14_02,3402.0,0.0,3918527.0,0.0,3918527.0,0.0
797,LFG,14_03,46954.0,0.0,3965481.0,0.0,3965481.0,0.0
798,LFG,14_04,103909.0,0.0,4069390.0,0.0,4069390.0,0.0
799,LFG,14_05,193850.0,0.0,4263240.0,0.0,4263240.0,0.0
800,LFG,14_06,35000.0,0.0,4298240.0,0.0,4298240.0,0.0
801,LFG,14_07,21325.0,0.0,4319565.0,0.0,4319565.0,0.0
802,LFG,14_09,75440.0,0.0,4395005.0,0.0,4395005.0,0.0
803,LFG,14_10,23173.0,0.0,4418178.0,0.0,4418178.0,0.0
804,LFG,14_11,6000.0,0.0,4424178.0,0.0,4424178.0,0.0
805,LFG,14_12,33645.0,0.0,4457823.0,0.0,4457823.0,0.0
806,LFG,15_01,354831.0,0.0,4812654.0,0.0,4812654.0,0.0
807,LFG,15_03,14935.0,0.0,4827589.0,0.0,4827589.0,0.0
808,LFG,15_04,212481.0,0.0,5040070.0,0.0,5040070.0,0.0
809,LFG,15_05,95206.0,0.0,5135276.0,0.0,5135276.0,0.0
810,LFG,15_06,260399.0,0.0,5395675.0,0.0,5395675.0,0.0
811,LFG,15_10,5000.0,0.0,5400675.0,0.0,5400675.0,0.0
812,LFG,15_11,60276.0,0.0,5460951.0,0.0,5460951.0,0.0
813,LFG,15_12,261931.0,0.0,5722882.0,0.0,5722882.0,0.0
814,LFG,16_01,5000.0,0.0,5727882.0,0.0,5727882.0,0.0
815,LFG,16_02,113625.0,0.0,5841507.0,0.0,5841507.0,0.0
816,LFG,16_03,74360.0,0.0,5915867.0,0.0,5915867.0,0.0
817,LFG,16_04,16762.0,0.0,5932629.0,0.0,5932629.0,0.0
818,LFG,16_05,33344.0,0.0,5965973.0,0.0,5965973.0,0.0
819,LFG,16_09,128162.0,0.0,6094135.0,0.0,6094135.0,0.0
820,LFG,17_01,14891.0,0.0,6109026.0,0.0,6109026.0,0.0
821,LFG,17_02,50362.0,0.0,6159388.0,0.0,6159388.0,0.0
822,LFG,17_03,26052.0,0.0,6185440.0,0.0,6185440.0,0.0
823,LFG,17_04,55079.0,0.0,6240519.0,0.0,6240519.0,0.0
824,LFG,17_06,76465.0,0.0,6316984.0,0.0,6316984.0,0.0
825,LFG,17_07,72996.0,0.0,6389980.0,0.0,6389980.0,0.0
826,LFG,17_09,5787.0,0.0,6395767.0,0.0,6395767.0,0.0
827,LFG,17_12,30505.0,0.0,6426272.0,0.0,6426272.0,0.0
828,LFG,18_01,31462.0,0.0,6457734.0,0.0,6457734.0,0.0
829,LFG,18_03,32415.0,0.0,6490149.0,0.0,6490149.0,0.0
830,LFG,18_04,79147.0,0.0,6569296.0,0.0,6569296.0,0.0
831,LFG,18_05,25116.0,0.0,6594412.0,0.0,6594412.0,0.0
832,LFG,19_01,6000.0,0.0,6600412.0,0.0,6600412.0,0.0
833,LFG,19_02,82964.0,0.0,6683376.0,0.0,6683376.0,0.0
834,LFG,19_03,232884.0,0.0,6916260.0,0.0,6916260.0,0.0
835,LFG,19_04,307992.0,0.0,7224252.0,0.0,7224252.0,0.0
836,LFG,19_05,21634.0,0.0,7245886.0,0.0,7245886.0,0.0
837,LFG,19_06,243416.0,0.0,7489302.0,0.0,7489302.0,0.0
838,LFG,19_08,859503.0,0.0,8348805.0,0.0,8348805.0,0.0
839,LFG,19_09,202450.0,0.0,8551255.0,0.0,8551255.0,0.0
840,LFG,19_10,225488.0,0.0,8776743.0,0.0,8776743.0,0.0
841,LFG,19_11,56788.0,0.0,8833531.0,0.0,8833531.0,0.0
842,LFG,19_12,97800.0,0.0,8931331.0,0.0,8931331.0,0.0
843,LFG,20_02,84910.0,0.0,9016241.0,0.0,9016241.0,0.0
844,LFG,20_03,139865.0,0.0,9156106.0,0.0,9156106.0,0.0
845,LFG,20_05,98866.0,0.0,9254972.0,0.0,9254972.0,0.0
846,LFG,20_06,779.0,0.0,9255751.0,0.0,9255751.0,0.0
847,LFG,20_08,69513.0,0.0,9325264.0,0.0,9325264.0,0.0
848,LFG,20_09,100000.0,0.0,9425264.0,0.0,9425264.0,0.0
849,LFG,20_10,99199.0,0.0,9524463.0,0.0,9524463.0,0.0
850,LFG,20_11,103063.0,0.0,9627526.0,0.0,9627526.0,0.0
851,LFG,20_12,389800.0,0.0,10017326.0,0.0,10017326.0,0.0
852,LFG,21_01,248607.0,0.0,10265933.0,0.0,10265933.0,0.0
853,LFG,21_03,122687.0,0.0,10388620.0,0.0,10388620.0,0.0
854,LFG,21_04,16247.0,0.0,10404867.0,0.0,10404867.0,0.0
855,LFG,21_05,272793.0,0.0,10677660.0,0.0,10677660.0,0.0
856,LFG,21_06,537670.0,0.0,11215330.0,0.0,11215330.0,0.0
857,LFG,21_07,235115.0,0.0,11450445.0,0.0,11450445.0,0.0
858,LFG,21_08,274453.0,0.0,11724898.0,0.0,11724898.0,0.0
859,LFG,21_09,1243273.0,0.0,12968171.0,0.0,12968171.0,0.0
860,LFG,21_11,405049.0,0.0,13373220.0,0.0,13373220.0,0.0
861,LFG,21_12,327133.0,0.0,13700353.0,0.0,13700353.0,0.0
862,LFG,22_01,269039.0,0.0,13969392.0,0.0,13969392.0,0.0
863,LFG,22_02,35233.0,0.0,14004625.0,0.0,14004625.0,0.0
864,LFG,22_03,156901.0,0.0,14161526.0,0.0,14161526.0,0.0
865,LFG,22_04,138969.0,0.0,14300495.0,0.0,14300495.0,0.0
866,LFG,22_05,908177.0,0.0,15208672.0,0.0,15208672.0,0.0
867,LFG,22_06,356214.0,0.0,15564886.0,0.0,15564886.0,0.0
868,LFG,22_07,113066.0,0.0,15677952.0,0.0,15677952.0,0.0
869,LFG,22_08,27711.0,0.0,15705663.0,0.0,15705663.0,0.0
870,LFG,22_09,100000.0,0.0,15805663.0,0.0,15805663.0,0.0
871,LFG,22_10,322036.0,0.0,16127699.0,0.0,16127699.0,0.0
872,LFG,22_11,36506.0,0.0,16164205.0,0.0,16164205.0,0.0
873,LFG,22_12,32504.0,0.0,16196709.0,0.0,16196709.0,0.0
874,LFG,23_01,752708.0,0.0,16949417.0,0.0,16949417.0,0.0
875,LFG,23_02,905576.0,0.0,17854993.0,0.0,17854993.0,0.0
876,LFG,23_03,91519.0,0.0,17946512.0,0.0,17946512.0,0.0
877,LFG,23_04,200652.0,0.0,18147164.0,0.0,18147164.0,0.0
878,LFG,23_05,820960.0,0.0,18968124.0,0.0,18968124.0,0.0
879,LFG,23_06,38980.0,60984.0,19007104.0,60984.0,18946120.0,0.0032084845750304726
880,LFG,23_07,219634.0,12624.0,19226738.0,73608.0,19153130.0,0.0038284185284055985
881,Livestock,11_06,8803.0,0.0,8803.0,0.0,8803.0,0.0
882,Livestock,11_07,392545.0,0.0,401348.0,0.0,401348.0,0.0
883,Livestock,12_10,8781.0,0.0,410129.0,0.0,410129.0,0.0
884,Livestock,13_05,30122.0,0.0,440251.0,0.0,440251.0,0.0
885,Livestock,13_07,3160.0,0.0,443411.0,0.0,443411.0,0.0
886,Livestock,13_11,4000.0,0.0,447411.0,0.0,447411.0,0.0
887,Livestock,13_12,20000.0,0.0,467411.0,0.0,467411.0,0.0
888,Livestock,14_07,8800.0,0.0,476211.0,0.0,476211.0,0.0
889,Livestock,16_02,1198.0,0.0,477409.0,0.0,477409.0,0.0
890,Livestock,17_01,165951.0,0.0,643360.0,0.0,643360.0,0.0
891,Livestock,20_11,6699.0,0.0,650059.0,0.0,650059.0,0.0
892,Livestock,21_01,20000.0,0.0,670059.0,0.0,670059.0,0.0
893,Livestock,21_06,25680.0,0.0,695739.0,0.0,695739.0,0.0
894,Livestock,22_10,34759.0,0.0,730498.0,0.0,730498.0,0.0
895,Livestock,23_05,20692.0,0.0,751190.0,0.0,751190.0,0.0
896,Other,09_03,341116.0,0.0,341116.0,0.0,341116.0,0.0
897,Other,09_04,1181556.0,0.0,1522672.0,0.0,1522672.0,0.0
898,Other,09_05,394528.0,0.0,1917200.0,0.0,1917200.0,0.0
899,Other,09_06,427153.0,0.0,2344353.0,0.0,2344353.0,0.0
900,Other,09_07,171837.0,0.0,2516190.0,0.0,2516190.0,0.0
901,Other,09_08,92606.0,0.0,2608796.0,0.0,2608796.0,0.0
902,Other,09_09,608681.0,0.0,3217477.0,0.0,3217477.0,0.0
903,Other,09_10,2242737.0,0.0,5460214.0,0.0,5460214.0,0.0
904,Other,09_11,1206855.0,0.0,6667069.0,0.0,6667069.0,0.0
905,Other,09_12,3968312.0,0.0,10635381.0,0.0,10635381.0,0.0
906,Other,10_01,1456899.0,0.0,12092280.0,0.0,12092280.0,0.0
907,Other,10_02,640307.0,0.0,12732587.0,0.0,12732587.0,0.0
908,Other,10_03,710609.0,0.0,13443196.0,0.0,13443196.0,0.0
909,Other,10_04,115905.0,0.0,13559101.0,0.0,13559101.0,0.0
910,Other,10_05,251803.0,0.0,13810904.0,0.0,13810904.0,0.0
911,Other,10_06,417670.0,0.0,14228574.0,0.0,14228574.0,0.0
912,Other,10_07,389718.0,0.0,14618292.0,0.0,14618292.0,0.0
913,Other,10_08,161183.0,0.0,14779475.0,0.0,14779475.0,0.0
914,Other,10_09,51356.0,0.0,14830831.0,0.0,14830831.0,0.0
915,Other,10_10,412566.0,0.0,15243397.0,0.0,15243397.0,0.0
916,Other,10_11,694677.0,0.0,15938074.0,0.0,15938074.0,0.0
917,Other,10_12,684137.0,0.0,16622211.0,0.0,16622211.0,0.0
918,Other,11_01,207113.0,0.0,16829324.0,0.0,16829324.0,0.0
919,Other,11_02,170297.0,0.0,16999621.0,0.0,16999621.0,0.0
920,Other,11_03,116140.0,0.0,17115761.0,0.0,17115761.0,0.0
921,Other,11_04,541114.0,0.0,17656875.0,0.0,17656875.0,0.0
922,Other,11_05,287697.0,0.0,17944572.0,0.0,17944572.0,0.0
923,Other,11_06,440497.0,0.0,18385069.0,0.0,18385069.0,0.0
924,Other,11_07,490322.0,0.0,18875391.0,0.0,18875391.0,0.0
925,Other,11_08,108980.0,0.0,18984371.0,0.0,18984371.0,0.0
926,Other,11_09,137544.0,0.0,19121915.0,0.0,19121915.0,0.0
927,Other,11_10,25975.0,0.0,19147890.0,0.0,19147890.0,0.0
928,Other,11_11,627462.0,0.0,19775352.0,0.0,19775352.0,0.0
929,Other,11_12,605765.0,0.0,20381117.0,0.0,20381117.0,0.0
930,Other,12_01,705054.0,0.0,21086171.0,0.0,21086171.0,0.0
931,Other,12_02,107191.0,0.0,21193362.0,0.0,21193362.0,0.0
932,Other,12_03,331866.0,0.0,21525228.0,0.0,21525228.0,0.0
933,Other,12_04,1345304.0,0.0,22870532.0,0.0,22870532.0,0.0
934,Other,12_05,476950.0,0.0,23347482.0,0.0,23347482.0,0.0
935,Other,12_06,433252.0,0.0,23780734.0,0.0,23780734.0,0.0
936,Other,12_07,228476.0,0.0,24009210.0,0.0,24009210.0,0.0
937,Other,12_08,380106.0,0.0,24389316.0,0.0,24389316.0,0.0
938,Other,12_09,245643.0,0.0,24634959.0,0.0,24634959.0,0.0
939,Other,12_10,210851.0,0.0,24845810.0,0.0,24845810.0,0.0
940,Other,12_11,374859.0,0.0,25220669.0,0.0,25220669.0,0.0
941,Other,12_12,574038.0,0.0,25794707.0,0.0,25794707.0,0.0
942,Other,13_01,313592.0,0.0,26108299.0,0.0,26108299.0,0.0
943,Other,13_02,246960.0,0.0,26355259.0,0.0,26355259.0,0.0
944,Other,13_03,53089.0,0.0,26408348.0,0.0,26408348.0,0.0
945,Other,13_04,902913.0,0.0,27311261.0,0.0,27311261.0,0.0
946,Other,13_05,422035.0,0.0,27733296.0,0.0,27733296.0,0.0
947,Other,13_06,68427.0,0.0,27801723.0,0.0,27801723.0,0.0
948,Other,13_07,35000.0,0.0,27836723.0,0.0,27836723.0,0.0
949,Other,13_08,35216.0,0.0,27871939.0,0.0,27871939.0,0.0
950,Other,13_09,76577.0,0.0,27948516.0,0.0,27948516.0,0.0
951,Other,13_10,41148.0,0.0,27989664.0,0.0,27989664.0,0.0
952,Other,13_11,85440.0,0.0,28075104.0,0.0,28075104.0,0.0
953,Other,13_12,116334.0,0.0,28191438.0,0.0,28191438.0,0.0
954,Other,14_01,285427.0,0.0,28476865.0,0.0,28476865.0,0.0
955,Other,14_02,173098.0,0.0,28649963.0,0.0,28649963.0,0.0
956,Other,14_03,37645.0,0.0,28687608.0,0.0,28687608.0,0.0
957,Other,14_04,139685.0,0.0,28827293.0,0.0,28827293.0,0.0
958,Other,14_05,248209.0,0.0,29075502.0,0.0,29075502.0,0.0
959,Other,14_06,250000.0,0.0,29325502.0,0.0,29325502.0,0.0
960,Other,14_08,67017.0,0.0,29392519.0,0.0,29392519.0,0.0
961,Other,14_09,231274.0,0.0,29623793.0,0.0,29623793.0,0.0
962,Other,14_10,26420.0,0.0,29650213.0,0.0,29650213.0,0.0
963,Other,14_11,130000.0,0.0,29780213.0,0.0,29780213.0,0.0
964,Other,14_12,245678.0,0.0,30025891.0,0.0,30025891.0,0.0
965,Other,15_01,43216.0,0.0,30069107.0,0.0,30069107.0,0.0
966,Other,15_02,46542.0,0.0,30115649.0,0.0,30115649.0,0.0
967,Other,15_03,101253.0,0.0,30216902.0,0.0,30216902.0,0.0
968,Other,15_04,22630.0,0.0,30239532.0,0.0,30239532.0,0.0
969,Other,15_05,10050.0,0.0,30249582.0,0.0,30249582.0,0.0
970,Other,15_06,272344.0,0.0,30521926.0,0.0,30521926.0,0.0
971,Other,15_07,219485.0,0.0,30741411.0,0.0,30741411.0,0.0
972,Other,15_08,484684.0,0.0,31226095.0,0.0,31226095.0,0.0
973,Other,15_09,539444.0,0.0,31765539.0,0.0,31765539.0,0.0
974,Other,15_11,74476.0,0.0,31840015.0,0.0,31840015.0,0.0
975,Other,15_12,560144.0,0.0,32400159.0,0.0,32400159.0,0.0
976,Other,16_01,149304.0,0.0,32549463.0,0.0,32549463.0,0.0
977,Other,16_02,83028.0,0.0,32632491.0,0.0,32632491.0,0.0
978,Other,16_03,172046.0,0.0,32804537.0,0.0,32804537.0,0.0
979,Other,16_04,179559.0,0.0,32984096.0,0.0,32984096.0,0.0
980,Other,16_05,40857.0,0.0,33024953.0,0.0,33024953.0,0.0
981,Other,16_06,55211.0,0.0,33080164.0,0.0,33080164.0,0.0
982,Other,16_07,65263.0,0.0,33145427.0,0.0,33145427.0,0.0
983,Other,16_08,25288.0,0.0,33170715.0,0.0,33170715.0,0.0
984,Other,16_10,158802.0,0.0,33329517.0,0.0,33329517.0,0.0
985,Other,16_11,39888.0,0.0,33369405.0,0.0,33369405.0,0.0
986,Other,16_12,1222717.0,0.0,34592122.0,0.0,34592122.0,0.0
987,Other,17_01,207019.0,0.0,34799141.0,0.0,34799141.0,0.0
988,Other,17_02,45431.0,0.0,34844572.0,0.0,34844572.0,0.0
989,Other,17_03,87384.0,0.0,34931956.0,0.0,34931956.0,0.0
990,Other,17_04,181322.0,0.0,35113278.0,0.0,35113278.0,0.0
991,Other,17_05,258778.0,0.0,35372056.0,0.0,35372056.0,0.0
992,Other,17_06,35139.0,0.0,35407195.0,0.0,35407195.0,0.0
993,Other,17_07,29466.0,0.0,35436661.0,0.0,35436661.0,0.0
994,Other,17_08,703944.0,0.0,36140605.0,0.0,36140605.0,0.0
995,Other,17_09,68338.0,0.0,36208943.0,0.0,36208943.0,0.0
996,Other,17_10,219200.0,0.0,36428143.0,0.0,36428143.0,0.0
997,Other,17_11,88596.0,0.0,36516739.0,0.0,36516739.0,0.0
998,Other,17_12,370902.0,0.0,36887641.0,0.0,36887641.0,0.0
999,Other,18_01,6000.0,0.0,36893641.0,0.0,36893641.0,0.0
1000,Other,18_02,38416.0,0.0,36932057.0,0.0,36932057.0,0.0
1001,Other,18_03,182411.0,0.0,37114468.0,0.0,37114468.0,0.0
1002,Other,18_04,74000.0,0.0,37188468.0,0.0,37188468.0,0.0
1003,Other,18_05,669081.0,0.0,37857549.0,0.0,37857549.0,0.0
1004,Other,18_06,136790.0,0.0,37994339.0,0.0,37994339.0,0.0
1005,Other,18_07,324345.0,0.0,38318684.0,0.0,38318684.0,0.0
1006,Other,18_08,295064.0,0.0,38613748.0,0.0,38613748.0,0.0
1007,Other,18_09,261919.0,0.0,38875667.0,0.0,38875667.0,0.0
1008,Other,18_10,7000.0,0.0,38882667.0,0.0,38882667.0,0.0
1009,Other,18_11,343219.0,0.0,39225886.0,0.0,39225886.0,0.0
1010,Other,18_12,306213.0,0.0,39532099.0,0.0,39532099.0,0.0
1011,Other,19_02,163094.0,0.0,39695193.0,0.0,39695193.0,0.0
1012,Other,19_03,136197.0,0.0,39831390.0,0.0,39831390.0,0.0
1013,Other,19_04,154396.0,0.0,39985786.0,0.0,39985786.0,0.0
1014,Other,19_05,152486.0,0.0,40138272.0,0.0,40138272.0,0.0
1015,Other,19_06,228116.0,0.0,40366388.0,0.0,40366388.0,0.0
1016,Other,19_07,663941.0,0.0,41030329.0,0.0,41030329.0,0.0
1017,Other,19_08,431633.0,0.0,41461962.0,0.0,41461962.0,0.0
1018,Other,19_09,351868.0,0.0,41813830.0,0.0,41813830.0,0.0
1019,Other,19_10,398113.0,0.0,42211943.0,0.0,42211943.0,0.0
1020,Other,19_11,855390.0,0.0,43067333.0,0.0,43067333.0,0.0
1021,Other,19_12,787648.0,0.0,43854981.0,0.0,43854981.0,0.0
1022,Other,20_01,1557361.0,0.0,45412342.0,0.0,45412342.0,0.0
1023,Other,20_02,732780.0,0.0,46145122.0,0.0,46145122.0,0.0
1024,Other,20_03,2790131.0,0.0,48935253.0,0.0,48935253.0,0.0
1025,Other,20_04,23922.0,0.0,48959175.0,0.0,48959175.0,0.0
1026,Other,20_05,65757.0,0.0,49024932.0,0.0,49024932.0,0.0
1027,Other,20_06,253999.0,0.0,49278931.0,0.0,49278931.0,0.0
1028,Other,20_07,1710044.0,0.0,50988975.0,0.0,50988975.0,0.0
1029,Other,20_08,515664.0,0.0,51504639.0,0.0,51504639.0,0.0
1030,Other,20_09,766305.0,0.0,52270944.0,0.0,52270944.0,0.0
1031,Other,20_10,246161.0,0.0,52517105.0,0.0,52517105.0,0.0
1032,Other,20_11,1470729.0,0.0,53987834.0,0.0,53987834.0,0.0
1033,Other,20_12,1990173.0,0.0,55978007.0,0.0,55978007.0,0.0
1034,Other,21_01,481772.0,0.0,56459779.0,0.0,56459779.0,0.0
1035,Other,21_02,1466492.0,0.0,57926271.0,0.0,57926271.0,0.0
1036,Other,21_03,1148945.0,0.0,59075216.0,0.0,59075216.0,0.0
1037,Other,21_04,3509892.0,0.0,62585108.0,0.0,62585108.0,0.0
1038,Other,21_05,2617173.0,0.0,65202281.0,0.0,65202281.0,0.0
1039,Other,21_06,5981478.0,0.0,71183759.0,0.0,71183759.0,0.0
1040,Other,21_07,873226.0,0.0,72056985.0,0.0,72056985.0,0.0
1041,Other,21_08,3289426.0,0.0,75346411.0,0.0,75346411.0,0.0
1042,Other,21_09,792130.0,0.0,76138541.0,0.0,76138541.0,0.0
1043,Other,21_10,1063236.0,0.0,77201777.0,0.0,77201777.0,0.0
1044,Other,21_11,1824884.0,0.0,79026661.0,0.0,79026661.0,0.0
1045,Other,21_12,2393560.0,0.0,81420221.0,0.0,81420221.0,0.0
1046,Other,22_01,1612150.0,0.0,83032371.0,0.0,83032371.0,0.0
1047,Other,22_02,2144216.0,0.0,85176587.0,0.0,85176587.0,0.0
1048,Other,22_03,1022271.0,0.0,86198858.0,0.0,86198858.0,0.0
1049,Other,22_04,1021754.0,0.0,87220612.0,0.0,87220612.0,0.0
1050,Other,22_05,592115.0,0.0,87812727.0,0.0,87812727.0,0.0
1051,Other,22_06,1596383.0,0.0,89409110.0,0.0,89409110.0,0.0
1052,Other,22_07,27080.0,0.0,89436190.0,0.0,89436190.0,0.0
1053,Other,22_08,652435.0,0.0,90088625.0,0.0,90088625.0,0.0
1054,Other,22_09,815571.0,0.0,90904196.0,0.0,90904196.0,0.0
1055,Other,22_10,681366.0,0.0,91585562.0,0.0,91585562.0,0.0
1056,Other,22_11,548176.0,0.0,92133738.0,0.0,92133738.0,0.0
1057,Other,22_12,2256005.0,0.0,94389743.0,0.0,94389743.0,0.0
1058,Other,23_01,2236048.0,0.0,96625791.0,0.0,96625791.0,0.0
1059,Other,23_02,1771339.0,0.0,98397130.0,0.0,98397130.0,0.0
1060,Other,23_03,1529119.0,0.0,99926249.0,0.0,99926249.0,0.0
1061,Other,23_04,673830.0,0.0,100600079.0,0.0,100600079.0,0.0
1062,Other,23_05,652749.0,0.0,101252828.0,0.0,101252828.0,0.0
1063,Other,23_06,809136.0,157.0,102061964.0,157.0,102061807.0,1.5382811955294138e-06
1064,Other,23_07,36859.0,279006.0,102098823.0,279163.0,101819660.0,0.0027342430774152998
1065,REDD,11_02,1151420.0,0.0,1151420.0,0.0,1151420.0,0.0
1066,REDD,11_05,25000.0,0.0,1176420.0,0.0,1176420.0,0.0
1067,REDD,11_06,979073.0,0.0,2155493.0,0.0,2155493.0,0.0
1068,REDD,11_07,133808.0,0.0,2289301.0,0.0,2289301.0,0.0
1069,REDD,11_09,58461.0,0.0,2347762.0,0.0,2347762.0,0.0
1070,REDD,12_06,100000.0,0.0,2447762.0,0.0,2447762.0,0.0
1071,REDD,12_10,4334.0,0.0,2452096.0,0.0,2452096.0,0.0
1072,REDD,12_11,2000.0,0.0,2454096.0,0.0,2454096.0,0.0
1073,REDD,12_12,2847553.0,0.0,5301649.0,0.0,5301649.0,0.0
1074,REDD,13_01,273517.0,0.0,5575166.0,0.0,5575166.0,0.0
1075,REDD,13_02,1000.0,0.0,5576166.0,0.0,5576166.0,0.0
1076,REDD,13_03,1606.0,0.0,5577772.0,0.0,5577772.0,0.0
1077,REDD,13_04,194541.0,0.0,5772313.0,0.0,5772313.0,0.0
1078,REDD,13_06,505060.0,0.0,6277373.0,0.0,6277373.0,0.0
1079,REDD,13_07,51000.0,0.0,6328373.0,0.0,6328373.0,0.0
1080,REDD,13_08,230500.0,0.0,6558873.0,0.0,6558873.0,0.0
1081,REDD,13_09,94020.0,0.0,6652893.0,0.0,6652893.0,0.0
1082,REDD,13_10,24671.0,0.0,6677564.0,0.0,6677564.0,0.0
1083,REDD,13_11,770032.0,0.0,7447596.0,0.0,7447596.0,0.0
1084,REDD,13_12,5163930.0,0.0,12611526.0,0.0,12611526.0,0.0
1085,REDD,14_01,571369.0,0.0,13182895.0,0.0,13182895.0,0.0
1086,REDD,14_02,210106.0,0.0,13393001.0,0.0,13393001.0,0.0
1087,REDD,14_03,1234236.0,0.0,14627237.0,0.0,14627237.0,0.0
1088,REDD,14_04,513548.0,0.0,15140785.0,0.0,15140785.0,0.0
1089,REDD,14_05,72276.0,0.0,15213061.0,0.0,15213061.0,0.0
1090,REDD,14_06,1234883.0,0.0,16447944.0,0.0,16447944.0,0.0
1091,REDD,14_07,430713.0,0.0,16878657.0,0.0,16878657.0,0.0
1092,REDD,14_08,63893.0,0.0,16942550.0,0.0,16942550.0,0.0
1093,REDD,14_09,512149.0,0.0,17454699.0,0.0,17454699.0,0.0
1094,REDD,14_10,436062.0,0.0,17890761.0,0.0,17890761.0,0.0
1095,REDD,14_11,64575.0,0.0,17955336.0,0.0,17955336.0,0.0
1096,REDD,14_12,192813.0,0.0,18148149.0,0.0,18148149.0,0.0
1097,REDD,15_01,349394.0,0.0,18497543.0,0.0,18497543.0,0.0
1098,REDD,15_02,865000.0,0.0,19362543.0,0.0,19362543.0,0.0
1099,REDD,15_03,245978.0,0.0,19608521.0,0.0,19608521.0,0.0
1100,REDD,15_04,201234.0,0.0,19809755.0,0.0,19809755.0,0.0
1101,REDD,15_05,128961.0,0.0,19938716.0,0.0,19938716.0,0.0
1102,REDD,15_06,210258.0,0.0,20148974.0,0.0,20148974.0,0.0
1103,REDD,15_07,537600.0,0.0,20686574.0,0.0,20686574.0,0.0
1104,REDD,15_08,573505.0,0.0,21260079.0,0.0,21260079.0,0.0
1105,REDD,15_09,55000.0,0.0,21315079.0,0.0,21315079.0,0.0
1106,REDD,15_10,919531.0,0.0,22234610.0,0.0,22234610.0,0.0
1107,REDD,15_11,338384.0,0.0,22572994.0,0.0,22572994.0,0.0
1108,REDD,15_12,1023055.0,0.0,23596049.0,0.0,23596049.0,0.0
1109,REDD,16_01,889542.0,0.0,24485591.0,0.0,24485591.0,0.0
1110,REDD,16_02,486127.0,0.0,24971718.0,0.0,24971718.0,0.0
1111,REDD,16_03,458205.0,0.0,25429923.0,0.0,25429923.0,0.0
1112,REDD,16_04,844706.0,0.0,26274629.0,0.0,26274629.0,0.0
1113,REDD,16_05,75100.0,0.0,26349729.0,0.0,26349729.0,0.0
1114,REDD,16_06,150283.0,0.0,26500012.0,0.0,26500012.0,0.0
1115,REDD,16_07,546407.0,0.0,27046419.0,0.0,27046419.0,0.0
1116,REDD,16_08,179744.0,0.0,27226163.0,0.0,27226163.0,0.0
1117,REDD,16_09,172754.0,0.0,27398917.0,0.0,27398917.0,0.0
1118,REDD,16_10,664948.0,0.0,28063865.0,0.0,28063865.0,0.0
1119,REDD,16_11,413897.0,0.0,28477762.0,0.0,28477762.0,0.0
1120,REDD,16_12,1275353.0,0.0,29753115.0,0.0,29753115.0,0.0
1121,REDD,17_01,1450870.0,0.0,31203985.0,0.0,31203985.0,0.0
1122,REDD,17_02,509044.0,0.0,31713029.0,0.0,31713029.0,0.0
1123,REDD,17_03,369570.0,0.0,32082599.0,0.0,32082599.0,0.0
1124,REDD,17_04,2537128.0,0.0,34619727.0,0.0,34619727.0,0.0
1125,REDD,17_05,131817.0,0.0,34751544.0,0.0,34751544.0,0.0
1126,REDD,17_06,169470.0,0.0,34921014.0,0.0,34921014.0,0.0
1127,REDD,17_07,88160.0,0.0,35009174.0,0.0,35009174.0,0.0
1128,REDD,17_08,1212632.0,0.0,36221806.0,0.0,36221806.0,0.0
1129,REDD,17_09,3324014.0,0.0,39545820.0,0.0,39545820.0,0.0
1130,REDD,17_10,7785486.0,0.0,47331306.0,0.0,47331306.0,0.0
1131,REDD,17_11,341560.0,0.0,47672866.0,0.0,47672866.0,0.0
1132,REDD,17_12,5765232.0,0.0,53438098.0,0.0,53438098.0,0.0
1133,REDD,18_01,5249535.0,0.0,58687633.0,0.0,58687633.0,0.0
1134,REDD,18_02,1370690.0,0.0,60058323.0,0.0,60058323.0,0.0
1135,REDD,18_03,922265.0,0.0,60980588.0,0.0,60980588.0,0.0
1136,REDD,18_04,1227434.0,0.0,62208022.0,0.0,62208022.0,0.0
1137,REDD,18_05,2078496.0,0.0,64286518.0,0.0,64286518.0,0.0
1138,REDD,18_06,1460321.0,0.0,65746839.0,0.0,65746839.0,0.0
1139,REDD,18_07,1333099.0,0.0,67079938.0,0.0,67079938.0,0.0
1140,REDD,18_08,1191011.0,0.0,68270949.0,0.0,68270949.0,0.0
1141,REDD,18_09,1031728.0,0.0,69302677.0,0.0,69302677.0,0.0
1142,REDD,18_10,1794524.0,0.0,71097201.0,0.0,71097201.0,0.0
1143,REDD,18_11,1027232.0,0.0,72124433.0,0.0,72124433.0,0.0
1144,REDD,18_12,1263150.0,0.0,73387583.0,0.0,73387583.0,0.0
1145,REDD,19_01,10486738.0,0.0,83874321.0,0.0,83874321.0,0.0
1146,REDD,19_02,1467132.0,0.0,85341453.0,0.0,85341453.0,0.0
1147,REDD,19_03,471259.0,0.0,85812712.0,0.0,85812712.0,0.0
1148,REDD,19_04,1412132.0,0.0,87224844.0,0.0,87224844.0,0.0
1149,REDD,19_05,6527717.0,0.0,93752561.0,0.0,93752561.0,0.0
1150,REDD,19_06,2628423.0,0.0,96380984.0,0.0,96380984.0,0.0
1151,REDD,19_07,10042477.0,0.0,106423461.0,0.0,106423461.0,0.0
1152,REDD,19_08,2194242.0,0.0,108617703.0,0.0,108617703.0,0.0
1153,REDD,19_09,2561268.0,0.0,111178971.0,0.0,111178971.0,0.0
1154,REDD,19_10,2113607.0,0.0,113292578.0,0.0,113292578.0,0.0
1155,REDD,19_11,5156557.0,0.0,118449135.0,0.0,118449135.0,0.0
1156,REDD,19_12,10391630.0,0.0,128840765.0,0.0,128840765.0,0.0
1157,REDD,20_01,2283430.0,0.0,131124195.0,0.0,131124195.0,0.0
1158,REDD,20_02,5421676.0,0.0,136545871.0,0.0,136545871.0,0.0
1159,REDD,20_03,2467265.0,0.0,139013136.0,0.0,139013136.0,0.0
1160,REDD,20_04,1646017.0,0.0,140659153.0,0.0,140659153.0,0.0
1161,REDD,20_05,1561775.0,0.0,142220928.0,0.0,142220928.0,0.0
1162,REDD,20_06,1090247.0,0.0,143311175.0,0.0,143311175.0,0.0
1163,REDD,20_07,5236404.0,0.0,148547579.0,0.0,148547579.0,0.0
1164,REDD,20_08,1117314.0,0.0,149664893.0,0.0,149664893.0,0.0
1165,REDD,20_09,3276409.0,0.0,152941302.0,0.0,152941302.0,0.0
1166,REDD,20_10,1409133.0,0.0,154350435.0,0.0,154350435.0,0.0
1167,REDD,20_11,1699816.0,0.0,156050251.0,0.0,156050251.0,0.0
1168,REDD,20_12,9132034.0,0.0,165182285.0,0.0,165182285.0,0.0
1169,REDD,21_01,2094484.0,0.0,167276769.0,0.0,167276769.0,0.0
1170,REDD,21_02,7947745.0,0.0,175224514.0,0.0,175224514.0,0.0
1171,REDD,21_03,27303924.0,0.0,202528438.0,0.0,202528438.0,0.0
1172,REDD,21_04,14969960.0,0.0,217498398.0,0.0,217498398.0,0.0
1173,REDD,21_05,4246894.0,0.0,221745292.0,0.0,221745292.0,0.0
1174,REDD,21_06,2124018.0,0.0,223869310.0,0.0,223869310.0,0.0
1175,REDD,21_07,4600187.0,0.0,228469497.0,0.0,228469497.0,0.0
1176,REDD,21_08,10148816.0,0.0,238618313.0,0.0,238618313.0,0.0
1177,REDD,21_09,24802269.0,0.0,263420582.0,0.0,263420582.0,0.0
1178,REDD,21_10,6737170.0,0.0,270157752.0,0.0,270157752.0,0.0
1179,REDD,21_11,4752863.0,0.0,274910615.0,0.0,274910615.0,0.0
1180,REDD,21_12,8626814.0,0.0,283537429.0,0.0,283537429.0,0.0
1181,REDD,22_01,2891146.0,0.0,286428575.0,0.0,286428575.0,0.0
1182,REDD,22_02,1494495.0,0.0,287923070.0,0.0,287923070.0,0.0
1183,REDD,22_03,14979124.0,0.0,302902194.0,0.0,302902194.0,0.0
1184,REDD,22_04,1402323.0,0.0,304304517.0,0.0,304304517.0,0.0
1185,REDD,22_05,3473434.0,0.0,307777951.0,0.0,307777951.0,0.0
1186,REDD,22_06,4809753.0,0.0,312587704.0,0.0,312587704.0,0.0
1187,REDD,22_07,1323050.0,0.0,313910754.0,0.0,313910754.0,0.0
1188,REDD,22_08,752115.0,0.0,314662869.0,0.0,314662869.0,0.0
1189,REDD,22_09,504388.0,0.0,315167257.0,0.0,315167257.0,0.0
1190,REDD,22_10,1266174.0,0.0,316433431.0,0.0,316433431.0,0.0
1191,REDD,22_11,6828358.0,0.0,323261789.0,0.0,323261789.0,0.0
1192,REDD,22_12,6061425.0,0.0,329323214.0,0.0,329323214.0,0.0
1193,REDD,23_01,5643718.0,0.0,334966932.0,0.0,334966932.0,0.0
1194,REDD,23_02,3810000.0,0.0,338776932.0,0.0,338776932.0,0.0
1195,REDD,23_03,776494.0,0.0,339553426.0,0.0,339553426.0,0.0
1196,REDD,23_04,13462368.0,0.0,353015794.0,0.0,353015794.0,0.0
1197,REDD,23_05,2490779.0,0.0,355506573.0,0.0,355506573.0,0.0
1198,REDD,23_06,10904568.0,720477.0,366411141.0,720477.0,365690664.0,0.0019663075692340918
1199,REDD,23_07,1273.0,201391.0,366412414.0,921868.0,365490546.0,0.0025159300416060684
1200,Solar,13_07,32158.0,0.0,32158.0,0.0,32158.0,0.0
1201,Solar,13_08,10234.0,0.0,42392.0,0.0,42392.0,0.0
1202,Solar,13_11,2224.0,0.0,44616.0,0.0,44616.0,0.0
1203,Solar,14_02,23620.0,0.0,68236.0,0.0,68236.0,0.0
1204,Solar,14_04,25586.0,0.0,93822.0,0.0,93822.0,0.0
1205,Solar,14_10,41272.0,0.0,135094.0,0.0,135094.0,0.0
1206,Solar,14_12,16183.0,0.0,151277.0,0.0,151277.0,0.0
1207,Solar,15_08,28298.0,0.0,179575.0,0.0,179575.0,0.0
1208,Solar,15_11,56805.0,0.0,236380.0,0.0,236380.0,0.0
1209,Solar,16_01,17567.0,0.0,253947.0,0.0,253947.0,0.0
1210,Solar,16_03,33405.0,0.0,287352.0,0.0,287352.0,0.0
1211,Solar,16_04,117692.0,0.0,405044.0,0.0,405044.0,0.0
1212,Solar,16_06,46399.0,0.0,451443.0,0.0,451443.0,0.0
1213,Solar,17_01,31740.0,0.0,483183.0,0.0,483183.0,0.0
1214,Solar,17_03,3502.0,0.0,486685.0,0.0,486685.0,0.0
1215,Solar,17_04,16500.0,0.0,503185.0,0.0,503185.0,0.0
1216,Solar,17_05,14949.0,0.0,518134.0,0.0,518134.0,0.0
1217,Solar,17_06,27000.0,0.0,545134.0,0.0,545134.0,0.0
1218,Solar,17_07,113000.0,0.0,658134.0,0.0,658134.0,0.0
1219,Solar,17_10,17712.0,0.0,675846.0,0.0,675846.0,0.0
1220,Solar,17_11,545991.0,0.0,1221837.0,0.0,1221837.0,0.0
1221,Solar,17_12,40159.0,0.0,1261996.0,0.0,1261996.0,0.0
1222,Solar,18_01,9039.0,0.0,1271035.0,0.0,1271035.0,0.0
1223,Solar,18_03,10000.0,0.0,1281035.0,0.0,1281035.0,0.0
1224,Solar,18_04,9422.0,0.0,1290457.0,0.0,1290457.0,0.0
1225,Solar,18_06,224351.0,0.0,1514808.0,0.0,1514808.0,0.0
1226,Solar,18_07,153270.0,0.0,1668078.0,0.0,1668078.0,0.0
1227,Solar,18_08,140164.0,0.0,1808242.0,0.0,1808242.0,0.0
1228,Solar,18_09,21968.0,0.0,1830210.0,0.0,1830210.0,0.0
1229,Solar,18_10,20000.0,0.0,1850210.0,0.0,1850210.0,0.0
1230,Solar,18_11,67925.0,0.0,1918135.0,0.0,1918135.0,0.0
1231,Solar,18_12,195978.0,0.0,2114113.0,0.0,2114113.0,0.0
1232,Solar,19_01,75700.0,0.0,2189813.0,0.0,2189813.0,0.0
1233,Solar,19_02,426375.0,0.0,2616188.0,0.0,2616188.0,0.0
1234,Solar,19_03,494705.0,0.0,3110893.0,0.0,3110893.0,0.0
1235,Solar,19_04,454122.0,0.0,3565015.0,0.0,3565015.0,0.0
1236,Solar,19_05,420728.0,0.0,3985743.0,0.0,3985743.0,0.0
1237,Solar,19_06,257000.0,0.0,4242743.0,0.0,4242743.0,0.0
1238,Solar,19_07,716678.0,0.0,4959421.0,0.0,4959421.0,0.0
1239,Solar,19_08,525380.0,0.0,5484801.0,0.0,5484801.0,0.0
1240,Solar,19_09,921856.0,0.0,6406657.0,0.0,6406657.0,0.0
1241,Solar,19_10,2578802.0,0.0,8985459.0,0.0,8985459.0,0.0
1242,Solar,19_11,2730871.0,0.0,11716330.0,0.0,11716330.0,0.0
1243,Solar,19_12,502081.0,0.0,12218411.0,0.0,12218411.0,0.0
1244,Solar,20_01,580566.0,0.0,12798977.0,0.0,12798977.0,0.0
1245,Solar,20_02,453961.0,0.0,13252938.0,0.0,13252938.0,0.0
1246,Solar,20_03,1140324.0,0.0,14393262.0,0.0,14393262.0,0.0
1247,Solar,20_05,628464.0,0.0,15021726.0,0.0,15021726.0,0.0
1248,Solar,20_06,2515875.0,0.0,17537601.0,0.0,17537601.0,0.0
1249,Solar,20_07,969305.0,0.0,18506906.0,0.0,18506906.0,0.0
1250,Solar,20_08,2107479.0,0.0,20614385.0,0.0,20614385.0,0.0
1251,Solar,20_09,2319406.0,0.0,22933791.0,0.0,22933791.0,0.0
1252,Solar,20_10,1291926.0,0.0,24225717.0,0.0,24225717.0,0.0
1253,Solar,20_11,3267093.0,0.0,27492810.0,0.0,27492810.0,0.0
1254,Solar,20_12,529634.0,0.0,28022444.0,0.0,28022444.0,0.0
1255,Solar,21_01,14947.0,0.0,28037391.0,0.0,28037391.0,0.0
1256,Solar,21_02,1208275.0,0.0,29245666.0,0.0,29245666.0,0.0
1257,Solar,21_03,651521.0,0.0,29897187.0,0.0,29897187.0,0.0
1258,Solar,21_04,236464.0,0.0,30133651.0,0.0,30133651.0,0.0
1259,Solar,21_05,2257610.0,0.0,32391261.0,0.0,32391261.0,0.0
1260,Solar,21_06,561751.0,0.0,32953012.0,0.0,32953012.0,0.0
1261,Solar,21_07,2883156.0,0.0,35836168.0,0.0,35836168.0,0.0
1262,Solar,21_08,4422835.0,0.0,40259003.0,0.0,40259003.0,0.0
1263,Solar,21_09,2850999.0,0.0,43110002.0,0.0,43110002.0,0.0
1264,Solar,21_10,3439510.0,0.0,46549512.0,0.0,46549512.0,0.0
1265,Solar,21_11,108444.0,0.0,46657956.0,0.0,46657956.0,0.0
1266,Solar,21_12,79067.0,0.0,46737023.0,0.0,46737023.0,0.0
1267,Solar,22_01,1410403.0,0.0,48147426.0,0.0,48147426.0,0.0
1268,Solar,22_02,1641209.0,0.0,49788635.0,0.0,49788635.0,0.0
1269,Solar,22_03,1506997.0,0.0,51295632.0,0.0,51295632.0,0.0
1270,Solar,22_04,1782518.0,0.0,53078150.0,0.0,53078150.0,0.0
1271,Solar,22_05,315441.0,0.0,53393591.0,0.0,53393591.0,0.0
1272,Solar,22_06,4959942.0,0.0,58353533.0,0.0,58353533.0,0.0
1273,Solar,22_07,807963.0,0.0,59161496.0,0.0,59161496.0,0.0
1274,Solar,22_08,797100.0,0.0,59958596.0,0.0,59958596.0,0.0
1275,Solar,22_09,543056.0,0.0,60501652.0,0.0,60501652.0,0.0
1276,Solar,22_10,178131.0,0.0,60679783.0,0.0,60679783.0,0.0
1277,Solar,22_11,557159.0,0.0,61236942.0,0.0,61236942.0,0.0
1278,Solar,22_12,671837.0,0.0,61908779.0,0.0,61908779.0,0.0
1279,Solar,23_01,1323371.0,0.0,63232150.0,0.0,63232150.0,0.0
1280,Solar,23_02,609167.0,0.0,63841317.0,0.0,63841317.0,0.0
1281,Solar,23_03,783669.0,0.0,64624986.0,0.0,64624986.0,0.0
1282,Solar,23_04,55094.0,0.0,64680080.0,0.0,64680080.0,0.0
1283,Solar,23_05,411862.0,0.0,65091942.0,0.0,65091942.0,0.0
1284,Solar,23_06,1265332.0,48905.0,66357274.0,48905.0,66308369.0,0.0007369953141836417
1285,Solar,23_07,204225.0,176188.0,66561499.0,225093.0,66336406.0,0.0033817297293740334
1286,Transport,10_09,90004.0,0.0,90004.0,0.0,90004.0,0.0
1287,Transport,14_05,2195.0,0.0,92199.0,0.0,92199.0,0.0
1288,Transport,16_07,11379.0,0.0,103578.0,0.0,103578.0,0.0
1289,Transport,17_02,5208.0,0.0,108786.0,0.0,108786.0,0.0
1290,Transport,17_04,44224.0,0.0,153010.0,0.0,153010.0,0.0
1291,Transport,17_09,7092.0,0.0,160102.0,0.0,160102.0,0.0
1292,Transport,18_02,8924.0,0.0,169026.0,0.0,169026.0,0.0
1293,Transport,19_05,7155.0,0.0,176181.0,0.0,176181.0,0.0
1294,Transport,20_01,240.0,0.0,176421.0,0.0,176421.0,0.0
1295,Transport,20_03,6446.0,0.0,182867.0,0.0,182867.0,0.0
1296,Transport,21_08,2122.0,0.0,184989.0,0.0,184989.0,0.0
1297,Transport,22_04,2309.0,0.0,187298.0,0.0,187298.0,0.0
1298,Transport,22_10,128.0,0.0,187426.0,0.0,187426.0,0.0
1299,Transport,22_12,5277.0,0.0,192703.0,0.0,192703.0,0.0
1300,Transport,23_02,2396.0,0.0,195099.0,0.0,195099.0,0.0
1301,Transport,23_07,0.0,156.0,195099.0,156.0,194943.0,0.000799594052250396
1302,Waste,09_03,786.0,0.0,786.0,0.0,786.0,0.0
1303,Waste,09_04,988413.0,0.0,989199.0,0.0,989199.0,0.0
1304,Waste,09_05,3095.0,0.0,992294.0,0.0,992294.0,0.0
1305,Waste,09_06,173848.0,0.0,1166142.0,0.0,1166142.0,0.0
1306,Waste,09_08,73615.0,0.0,1239757.0,0.0,1239757.0,0.0
1307,Waste,09_10,38803.0,0.0,1278560.0,0.0,1278560.0,0.0
1308,Waste,09_11,241541.0,0.0,1520101.0,0.0,1520101.0,0.0
1309,Waste,09_12,359643.0,0.0,1879744.0,0.0,1879744.0,0.0
1310,Waste,10_02,270086.0,0.0,2149830.0,0.0,2149830.0,0.0
1311,Waste,10_03,52825.0,0.0,2202655.0,0.0,2202655.0,0.0
1312,Waste,10_04,18073.0,0.0,2220728.0,0.0,2220728.0,0.0
1313,Waste,10_05,84687.0,0.0,2305415.0,0.0,2305415.0,0.0
1314,Waste,10_06,118262.0,0.0,2423677.0,0.0,2423677.0,0.0
1315,Waste,10_07,209198.0,0.0,2632875.0,0.0,2632875.0,0.0
1316,Waste,10_08,5044.0,0.0,2637919.0,0.0,2637919.0,0.0
1317,Waste,10_09,7900.0,0.0,2645819.0,0.0,2645819.0,0.0
1318,Waste,10_10,106525.0,0.0,2752344.0,0.0,2752344.0,0.0
1319,Waste,10_11,2000.0,0.0,2754344.0,0.0,2754344.0,0.0
1320,Waste,10_12,278171.0,0.0,3032515.0,0.0,3032515.0,0.0
1321,Waste,11_04,33244.0,0.0,3065759.0,0.0,3065759.0,0.0
1322,Waste,11_05,87701.0,0.0,3153460.0,0.0,3153460.0,0.0
1323,Waste,11_06,70435.0,0.0,3223895.0,0.0,3223895.0,0.0
1324,Waste,11_07,252312.0,0.0,3476207.0,0.0,3476207.0,0.0
1325,Waste,11_09,56284.0,0.0,3532491.0,0.0,3532491.0,0.0
1326,Waste,11_10,23161.0,0.0,3555652.0,0.0,3555652.0,0.0
1327,Waste,11_11,19424.0,0.0,3575076.0,0.0,3575076.0,0.0
1328,Waste,11_12,350765.0,0.0,3925841.0,0.0,3925841.0,0.0
1329,Waste,12_06,128015.0,0.0,4053856.0,0.0,4053856.0,0.0
1330,Waste,12_07,8917.0,0.0,4062773.0,0.0,4062773.0,0.0
1331,Waste,12_08,9000.0,0.0,4071773.0,0.0,4071773.0,0.0
1332,Waste,12_09,30000.0,0.0,4101773.0,0.0,4101773.0,0.0
1333,Waste,12_10,98903.0,0.0,4200676.0,0.0,4200676.0,0.0
1334,Waste,12_11,347941.0,0.0,4548617.0,0.0,4548617.0,0.0
1335,Waste,12_12,198058.0,0.0,4746675.0,0.0,4746675.0,0.0
1336,Waste,13_04,296305.0,0.0,5042980.0,0.0,5042980.0,0.0
1337,Waste,13_06,125903.0,0.0,5168883.0,0.0,5168883.0,0.0
1338,Waste,13_07,34563.0,0.0,5203446.0,0.0,5203446.0,0.0
1339,Waste,13_08,8590.0,0.0,5212036.0,0.0,5212036.0,0.0
1340,Waste,14_02,12000.0,0.0,5224036.0,0.0,5224036.0,0.0
1341,Waste,14_03,29005.0,0.0,5253041.0,0.0,5253041.0,0.0
1342,Waste,14_04,17973.0,0.0,5271014.0,0.0,5271014.0,0.0
1343,Waste,14_05,20969.0,0.0,5291983.0,0.0,5291983.0,0.0
1344,Waste,14_08,12474.0,0.0,5304457.0,0.0,5304457.0,0.0
1345,Waste,14_11,3247.0,0.0,5307704.0,0.0,5307704.0,0.0
1346,Waste,14_12,7277.0,0.0,5314981.0,0.0,5314981.0,0.0
1347,Waste,15_02,5128.0,0.0,5320109.0,0.0,5320109.0,0.0
1348,Waste,15_03,5000.0,0.0,5325109.0,0.0,5325109.0,0.0
1349,Waste,15_04,9655.0,0.0,5334764.0,0.0,5334764.0,0.0
1350,Waste,15_05,40154.0,0.0,5374918.0,0.0,5374918.0,0.0
1351,Waste,15_06,16000.0,0.0,5390918.0,0.0,5390918.0,0.0
1352,Waste,15_09,17500.0,0.0,5408418.0,0.0,5408418.0,0.0
1353,Waste,15_12,65365.0,0.0,5473783.0,0.0,5473783.0,0.0
1354,Waste,16_02,6000.0,0.0,5479783.0,0.0,5479783.0,0.0
1355,Waste,16_05,73833.0,0.0,5553616.0,0.0,5553616.0,0.0
1356,Waste,16_06,3500.0,0.0,5557116.0,0.0,5557116.0,0.0
1357,Waste,16_07,23000.0,0.0,5580116.0,0.0,5580116.0,0.0
1358,Waste,16_09,25229.0,0.0,5605345.0,0.0,5605345.0,0.0
1359,Waste,16_10,5000.0,0.0,5610345.0,0.0,5610345.0,0.0
1360,Waste,16_11,29122.0,0.0,5639467.0,0.0,5639467.0,0.0
1361,Waste,16_12,137686.0,0.0,5777153.0,0.0,5777153.0,0.0
1362,Waste,17_02,33197.0,0.0,5810350.0,0.0,5810350.0,0.0
1363,Waste,17_04,36000.0,0.0,5846350.0,0.0,5846350.0,0.0
1364,Waste,17_05,40356.0,0.0,5886706.0,0.0,5886706.0,0.0
1365,Waste,17_06,156684.0,0.0,6043390.0,0.0,6043390.0,0.0
1366,Waste,17_07,215687.0,0.0,6259077.0,0.0,6259077.0,0.0
1367,Waste,17_08,89965.0,0.0,6349042.0,0.0,6349042.0,0.0
1368,Waste,17_09,104043.0,0.0,6453085.0,0.0,6453085.0,0.0
1369,Waste,17_10,14000.0,0.0,6467085.0,0.0,6467085.0,0.0
1370,Waste,17_11,11000.0,0.0,6478085.0,0.0,6478085.0,0.0
1371,Waste,17_12,16000.0,0.0,6494085.0,0.0,6494085.0,0.0
1372,Waste,18_04,59882.0,0.0,6553967.0,0.0,6553967.0,0.0
1373,Waste,18_07,106992.0,0.0,6660959.0,0.0,6660959.0,0.0
1374,Waste,18_08,60000.0,0.0,6720959.0,0.0,6720959.0,0.0
1375,Waste,18_09,143630.0,0.0,6864589.0,0.0,6864589.0,0.0
1376,Waste,18_10,21567.0,0.0,6886156.0,0.0,6886156.0,0.0
1377,Waste,18_11,41986.0,0.0,6928142.0,0.0,6928142.0,0.0
1378,Waste,18_12,48419.0,0.0,6976561.0,0.0,6976561.0,0.0
1379,Waste,19_02,143371.0,0.0,7119932.0,0.0,7119932.0,0.0
1380,Waste,19_03,43043.0,0.0,7162975.0,0.0,7162975.0,0.0
1381,Waste,19_04,11850.0,0.0,7174825.0,0.0,7174825.0,0.0
1382,Waste,19_05,88597.0,0.0,7263422.0,0.0,7263422.0,0.0
1383,Waste,19_06,246794.0,0.0,7510216.0,0.0,7510216.0,0.0
1384,Waste,19_07,27300.0,0.0,7537516.0,0.0,7537516.0,0.0
1385,Waste,19_08,225864.0,0.0,7763380.0,0.0,7763380.0,0.0
1386,Waste,19_09,238096.0,0.0,8001476.0,0.0,8001476.0,0.0
1387,Waste,19_10,35264.0,0.0,8036740.0,0.0,8036740.0,0.0
1388,Waste,19_11,12909.0,0.0,8049649.0,0.0,8049649.0,0.0
1389,Waste,19_12,25391.0,0.0,8075040.0,0.0,8075040.0,0.0
1390,Waste,20_01,74396.0,0.0,8149436.0,0.0,8149436.0,0.0
1391,Waste,20_02,110933.0,0.0,8260369.0,0.0,8260369.0,0.0
1392,Waste,20_03,68093.0,0.0,8328462.0,0.0,8328462.0,0.0
1393,Waste,20_05,30801.0,0.0,8359263.0,0.0,8359263.0,0.0
1394,Waste,20_06,752.0,0.0,8360015.0,0.0,8360015.0,0.0
1395,Waste,20_07,14114.0,0.0,8374129.0,0.0,8374129.0,0.0
1396,Waste,20_08,105000.0,0.0,8479129.0,0.0,8479129.0,0.0
1397,Waste,20_09,428827.0,0.0,8907956.0,0.0,8907956.0,0.0
1398,Waste,20_10,23933.0,0.0,8931889.0,0.0,8931889.0,0.0
1399,Waste,20_11,71719.0,0.0,9003608.0,0.0,9003608.0,0.0
1400,Waste,20_12,157129.0,0.0,9160737.0,0.0,9160737.0,0.0
1401,Waste,21_01,4426.0,0.0,9165163.0,0.0,9165163.0,0.0
1402,Waste,21_03,50597.0,0.0,9215760.0,0.0,9215760.0,0.0
1403,Waste,21_04,187212.0,0.0,9402972.0,0.0,9402972.0,0.0
1404,Waste,21_05,27817.0,0.0,9430789.0,0.0,9430789.0,0.0
1405,Waste,21_06,52119.0,0.0,9482908.0,0.0,9482908.0,0.0
1406,Waste,21_07,260914.0,0.0,9743822.0,0.0,9743822.0,0.0
1407,Waste,21_08,12833.0,0.0,9756655.0,0.0,9756655.0,0.0
1408,Waste,21_09,51934.0,0.0,9808589.0,0.0,9808589.0,0.0
1409,Waste,21_10,310904.0,0.0,10119493.0,0.0,10119493.0,0.0
1410,Waste,21_11,1220038.0,0.0,11339531.0,0.0,11339531.0,0.0
1411,Waste,21_12,85247.0,0.0,11424778.0,0.0,11424778.0,0.0
1412,Waste,22_01,63261.0,0.0,11488039.0,0.0,11488039.0,0.0
1413,Waste,22_02,30900.0,0.0,11518939.0,0.0,11518939.0,0.0
1414,Waste,22_03,66029.0,0.0,11584968.0,0.0,11584968.0,0.0
1415,Waste,22_04,195949.0,0.0,11780917.0,0.0,11780917.0,0.0
1416,Waste,22_05,290349.0,0.0,12071266.0,0.0,12071266.0,0.0
1417,Waste,22_06,102563.0,0.0,12173829.0,0.0,12173829.0,0.0
1418,Waste,22_07,179075.0,0.0,12352904.0,0.0,12352904.0,0.0
1419,Waste,22_08,537792.0,0.0,12890696.0,0.0,12890696.0,0.0
1420,Waste,22_09,144884.0,0.0,13035580.0,0.0,13035580.0,0.0
1421,Waste,22_10,133999.0,0.0,13169579.0,0.0,13169579.0,0.0
1422,Waste,22_11,226570.0,0.0,13396149.0,0.0,13396149.0,0.0
1423,Waste,22_12,811362.0,0.0,14207511.0,0.0,14207511.0,0.0
1424,Waste,23_01,457364.0,0.0,14664875.0,0.0,14664875.0,0.0
1425,Waste,23_02,254205.0,0.0,14919080.0,0.0,14919080.0,0.0
1426,Waste,23_03,1904783.0,0.0,16823863.0,0.0,16823863.0,0.0
1427,Waste,23_04,20000.0,0.0,16843863.0,0.0,16843863.0,0.0
1428,Waste,23_05,528775.0,0.0,17372638.0,0.0,17372638.0,0.0
1429,Waste,23_06,358282.0,174599.0,17730920.0,174599.0,17556321.0,0.009847148371319706
1430,Waste,23_07,226324.0,48767.0,17957244.0,223366.0,17733878.0,0.012438768443531758
1431,Wind,09_03,39064.0,0.0,39064.0,0.0,39064.0,0.0
1432,Wind,09_04,59139.0,0.0,98203.0,0.0,98203.0,0.0
1433,Wind,09_05,37330.0,0.0,135533.0,0.0,135533.0,0.0
1434,Wind,09_06,323124.0,0.0,458657.0,0.0,458657.0,0.0
1435,Wind,09_07,502134.0,0.0,960791.0,0.0,960791.0,0.0
1436,Wind,09_08,48441.0,0.0,1009232.0,0.0,1009232.0,0.0
1437,Wind,09_09,252436.0,0.0,1261668.0,0.0,1261668.0,0.0
1438,Wind,09_10,583357.0,0.0,1845025.0,0.0,1845025.0,0.0
1439,Wind,09_11,80601.0,0.0,1925626.0,0.0,1925626.0,0.0
1440,Wind,09_12,260148.0,0.0,2185774.0,0.0,2185774.0,0.0
1441,Wind,10_01,373151.0,0.0,2558925.0,0.0,2558925.0,0.0
1442,Wind,10_02,245037.0,0.0,2803962.0,0.0,2803962.0,0.0
1443,Wind,10_03,867057.0,0.0,3671019.0,0.0,3671019.0,0.0
1444,Wind,10_04,299868.0,0.0,3970887.0,0.0,3970887.0,0.0
1445,Wind,10_05,1215354.0,0.0,5186241.0,0.0,5186241.0,0.0
1446,Wind,10_06,358285.0,0.0,5544526.0,0.0,5544526.0,0.0
1447,Wind,10_07,220255.0,0.0,5764781.0,0.0,5764781.0,0.0
1448,Wind,10_08,666251.0,0.0,6431032.0,0.0,6431032.0,0.0
1449,Wind,10_09,426005.0,0.0,6857037.0,0.0,6857037.0,0.0
1450,Wind,10_10,412594.0,0.0,7269631.0,0.0,7269631.0,0.0
1451,Wind,10_11,735045.0,0.0,8004676.0,0.0,8004676.0,0.0
1452,Wind,10_12,682694.0,0.0,8687370.0,0.0,8687370.0,0.0
1453,Wind,11_01,535713.0,0.0,9223083.0,0.0,9223083.0,0.0
1454,Wind,11_02,33100.0,0.0,9256183.0,0.0,9256183.0,0.0
1455,Wind,11_03,412352.0,0.0,9668535.0,0.0,9668535.0,0.0
1456,Wind,11_04,203882.0,0.0,9872417.0,0.0,9872417.0,0.0
1457,Wind,11_05,539228.0,0.0,10411645.0,0.0,10411645.0,0.0
1458,Wind,11_06,697368.0,0.0,11109013.0,0.0,11109013.0,0.0
1459,Wind,11_07,397248.0,0.0,11506261.0,0.0,11506261.0,0.0
1460,Wind,11_08,293028.0,0.0,11799289.0,0.0,11799289.0,0.0
1461,Wind,11_09,56312.0,0.0,11855601.0,0.0,11855601.0,0.0
1462,Wind,11_10,775642.0,0.0,12631243.0,0.0,12631243.0,0.0
1463,Wind,11_11,370904.0,0.0,13002147.0,0.0,13002147.0,0.0
1464,Wind,11_12,2202714.0,0.0,15204861.0,0.0,15204861.0,0.0
1465,Wind,12_01,134339.0,0.0,15339200.0,0.0,15339200.0,0.0
1466,Wind,12_02,1271356.0,0.0,16610556.0,0.0,16610556.0,0.0
1467,Wind,12_03,777963.0,0.0,17388519.0,0.0,17388519.0,0.0
1468,Wind,12_04,2310732.0,0.0,19699251.0,0.0,19699251.0,0.0
1469,Wind,12_05,616529.0,0.0,20315780.0,0.0,20315780.0,0.0
1470,Wind,12_06,757499.0,0.0,21073279.0,0.0,21073279.0,0.0
1471,Wind,12_07,12726.0,0.0,21086005.0,0.0,21086005.0,0.0
1472,Wind,12_08,431235.0,0.0,21517240.0,0.0,21517240.0,0.0
1473,Wind,12_09,654435.0,0.0,22171675.0,0.0,22171675.0,0.0
1474,Wind,12_10,220100.0,0.0,22391775.0,0.0,22391775.0,0.0
1475,Wind,12_11,779713.0,0.0,23171488.0,0.0,23171488.0,0.0
1476,Wind,12_12,517363.0,0.0,23688851.0,0.0,23688851.0,0.0
1477,Wind,13_01,116295.0,0.0,23805146.0,0.0,23805146.0,0.0
1478,Wind,13_02,303645.0,0.0,24108791.0,0.0,24108791.0,0.0
1479,Wind,13_03,1362592.0,0.0,25471383.0,0.0,25471383.0,0.0
1480,Wind,13_04,1054753.0,0.0,26526136.0,0.0,26526136.0,0.0
1481,Wind,13_05,778377.0,0.0,27304513.0,0.0,27304513.0,0.0
1482,Wind,13_06,1286267.0,0.0,28590780.0,0.0,28590780.0,0.0
1483,Wind,13_07,1054884.0,0.0,29645664.0,0.0,29645664.0,0.0
1484,Wind,13_08,213123.0,0.0,29858787.0,0.0,29858787.0,0.0
1485,Wind,13_09,218263.0,0.0,30077050.0,0.0,30077050.0,0.0
1486,Wind,13_10,569461.0,0.0,30646511.0,0.0,30646511.0,0.0
1487,Wind,13_11,86129.0,0.0,30732640.0,0.0,30732640.0,0.0
1488,Wind,13_12,286000.0,0.0,31018640.0,0.0,31018640.0,0.0
1489,Wind,14_01,319999.0,0.0,31338639.0,0.0,31338639.0,0.0
1490,Wind,14_02,78398.0,0.0,31417037.0,0.0,31417037.0,0.0
1491,Wind,14_03,184518.0,0.0,31601555.0,0.0,31601555.0,0.0
1492,Wind,14_04,1489762.0,0.0,33091317.0,0.0,33091317.0,0.0
1493,Wind,14_05,29314.0,0.0,33120631.0,0.0,33120631.0,0.0
1494,Wind,14_06,802866.0,0.0,33923497.0,0.0,33923497.0,0.0
1495,Wind,14_07,536283.0,0.0,34459780.0,0.0,34459780.0,0.0
1496,Wind,14_08,306805.0,0.0,34766585.0,0.0,34766585.0,0.0
1497,Wind,14_09,378102.0,0.0,35144687.0,0.0,35144687.0,0.0
1498,Wind,14_10,273045.0,0.0,35417732.0,0.0,35417732.0,0.0
1499,Wind,14_11,530097.0,0.0,35947829.0,0.0,35947829.0,0.0
1500,Wind,14_12,485957.0,0.0,36433786.0,0.0,36433786.0,0.0
1501,Wind,15_01,38062.0,0.0,36471848.0,0.0,36471848.0,0.0
1502,Wind,15_02,490575.0,0.0,36962423.0,0.0,36962423.0,0.0
1503,Wind,15_03,205381.0,0.0,37167804.0,0.0,37167804.0,0.0
1504,Wind,15_04,323374.0,0.0,37491178.0,0.0,37491178.0,0.0
1505,Wind,15_05,189875.0,0.0,37681053.0,0.0,37681053.0,0.0
1506,Wind,15_06,1187487.0,0.0,38868540.0,0.0,38868540.0,0.0
1507,Wind,15_07,717891.0,0.0,39586431.0,0.0,39586431.0,0.0
1508,Wind,15_08,27841.0,0.0,39614272.0,0.0,39614272.0,0.0
1509,Wind,15_09,924877.0,0.0,40539149.0,0.0,40539149.0,0.0
1510,Wind,15_10,164595.0,0.0,40703744.0,0.0,40703744.0,0.0
1511,Wind,15_11,460236.0,0.0,41163980.0,0.0,41163980.0,0.0
1512,Wind,15_12,297589.0,0.0,41461569.0,0.0,41461569.0,0.0
1513,Wind,16_01,519332.0,0.0,41980901.0,0.0,41980901.0,0.0
1514,Wind,16_02,519759.0,0.0,42500660.0,0.0,42500660.0,0.0
1515,Wind,16_03,30616.0,0.0,42531276.0,0.0,42531276.0,0.0
1516,Wind,16_04,105898.0,0.0,42637174.0,0.0,42637174.0,0.0
1517,Wind,16_05,273532.0,0.0,42910706.0,0.0,42910706.0,0.0
1518,Wind,16_06,284786.0,0.0,43195492.0,0.0,43195492.0,0.0
1519,Wind,16_07,393882.0,0.0,43589374.0,0.0,43589374.0,0.0
1520,Wind,16_08,25000.0,0.0,43614374.0,0.0,43614374.0,0.0
1521,Wind,16_09,1148996.0,0.0,44763370.0,0.0,44763370.0,0.0
1522,Wind,16_10,75187.0,0.0,44838557.0,0.0,44838557.0,0.0
1523,Wind,16_11,203500.0,0.0,45042057.0,0.0,45042057.0,0.0
1524,Wind,16_12,1132644.0,0.0,46174701.0,0.0,46174701.0,0.0
1525,Wind,17_01,155216.0,0.0,46329917.0,0.0,46329917.0,0.0
1526,Wind,17_02,262209.0,0.0,46592126.0,0.0,46592126.0,0.0
1527,Wind,17_03,522312.0,0.0,47114438.0,0.0,47114438.0,0.0
1528,Wind,17_04,296158.0,0.0,47410596.0,0.0,47410596.0,0.0
1529,Wind,17_05,538984.0,0.0,47949580.0,0.0,47949580.0,0.0
1530,Wind,17_06,271594.0,0.0,48221174.0,0.0,48221174.0,0.0
1531,Wind,17_07,691574.0,0.0,48912748.0,0.0,48912748.0,0.0
1532,Wind,17_08,440150.0,0.0,49352898.0,0.0,49352898.0,0.0
1533,Wind,17_09,575424.0,0.0,49928322.0,0.0,49928322.0,0.0
1534,Wind,17_10,605277.0,0.0,50533599.0,0.0,50533599.0,0.0
1535,Wind,17_11,362923.0,0.0,50896522.0,0.0,50896522.0,0.0
1536,Wind,17_12,776349.0,0.0,51672871.0,0.0,51672871.0,0.0
1537,Wind,18_01,130000.0,0.0,51802871.0,0.0,51802871.0,0.0
1538,Wind,18_02,680359.0,0.0,52483230.0,0.0,52483230.0,0.0
1539,Wind,18_03,451447.0,0.0,52934677.0,0.0,52934677.0,0.0
1540,Wind,18_04,1238536.0,0.0,54173213.0,0.0,54173213.0,0.0
1541,Wind,18_05,779770.0,0.0,54952983.0,0.0,54952983.0,0.0
1542,Wind,18_06,639470.0,0.0,55592453.0,0.0,55592453.0,0.0
1543,Wind,18_07,556967.0,0.0,56149420.0,0.0,56149420.0,0.0
1544,Wind,18_08,990416.0,0.0,57139836.0,0.0,57139836.0,0.0
1545,Wind,18_09,951247.0,0.0,58091083.0,0.0,58091083.0,0.0
1546,Wind,18_10,260054.0,0.0,58351137.0,0.0,58351137.0,0.0
1547,Wind,18_11,191385.0,0.0,58542522.0,0.0,58542522.0,0.0
1548,Wind,18_12,664326.0,0.0,59206848.0,0.0,59206848.0,0.0
1549,Wind,19_01,647109.0,0.0,59853957.0,0.0,59853957.0,0.0
1550,Wind,19_02,265406.0,0.0,60119363.0,0.0,60119363.0,0.0
1551,Wind,19_03,2270263.0,0.0,62389626.0,0.0,62389626.0,0.0
1552,Wind,19_04,1097084.0,0.0,63486710.0,0.0,63486710.0,0.0
1553,Wind,19_05,823792.0,0.0,64310502.0,0.0,64310502.0,0.0
1554,Wind,19_06,1062357.0,0.0,65372859.0,0.0,65372859.0,0.0
1555,Wind,19_07,1534885.0,0.0,66907744.0,0.0,66907744.0,0.0
1556,Wind,19_08,1670230.0,0.0,68577974.0,0.0,68577974.0,0.0
1557,Wind,19_09,1493978.0,0.0,70071952.0,0.0,70071952.0,0.0
1558,Wind,19_10,1360862.0,0.0,71432814.0,0.0,71432814.0,0.0
1559,Wind,19_11,1618483.0,0.0,73051297.0,0.0,73051297.0,0.0
1560,Wind,19_12,7806013.0,0.0,80857310.0,0.0,80857310.0,0.0
1561,Wind,20_01,3650360.0,0.0,84507670.0,0.0,84507670.0,0.0
1562,Wind,20_02,1110845.0,0.0,85618515.0,0.0,85618515.0,0.0
1563,Wind,20_03,6879162.0,0.0,92497677.0,0.0,92497677.0,0.0
1564,Wind,20_04,427766.0,0.0,92925443.0,0.0,92925443.0,0.0
1565,Wind,20_05,2420602.0,0.0,95346045.0,0.0,95346045.0,0.0
1566,Wind,20_06,825613.0,0.0,96171658.0,0.0,96171658.0,0.0
1567,Wind,20_07,1756786.0,0.0,97928444.0,0.0,97928444.0,0.0
1568,Wind,20_08,1023378.0,0.0,98951822.0,0.0,98951822.0,0.0
1569,Wind,20_09,1176555.0,0.0,100128377.0,0.0,100128377.0,0.0
1570,Wind,20_10,3518236.0,0.0,103646613.0,0.0,103646613.0,0.0
1571,Wind,20_11,3699703.0,0.0,107346316.0,0.0,107346316.0,0.0
1572,Wind,20_12,1935904.0,0.0,109282220.0,0.0,109282220.0,0.0
1573,Wind,21_01,2253993.0,0.0,111536213.0,0.0,111536213.0,0.0
1574,Wind,21_02,2734304.0,0.0,114270517.0,0.0,114270517.0,0.0
1575,Wind,21_03,1099472.0,0.0,115369989.0,0.0,115369989.0,0.0
1576,Wind,21_04,3240786.0,0.0,118610775.0,0.0,118610775.0,0.0
1577,Wind,21_05,4800207.0,0.0,123410982.0,0.0,123410982.0,0.0
1578,Wind,21_06,3042030.0,0.0,126453012.0,0.0,126453012.0,0.0
1579,Wind,21_07,1642083.0,0.0,128095095.0,0.0,128095095.0,0.0
1580,Wind,21_08,4299158.0,0.0,132394253.0,0.0,132394253.0,0.0
1581,Wind,21_09,3267037.0,0.0,135661290.0,0.0,135661290.0,0.0
1582,Wind,21_10,3974761.0,0.0,139636051.0,0.0,139636051.0,0.0
1583,Wind,21_11,1107151.0,0.0,140743202.0,0.0,140743202.0,0.0
1584,Wind,21_12,1371629.0,0.0,142114831.0,0.0,142114831.0,0.0
1585,Wind,22_01,2173828.0,0.0,144288659.0,0.0,144288659.0,0.0
1586,Wind,22_02,3663660.0,0.0,147952319.0,0.0,147952319.0,0.0
1587,Wind,22_03,1153757.0,0.0,149106076.0,0.0,149106076.0,0.0
1588,Wind,22_04,4562589.0,0.0,153668665.0,0.0,153668665.0,0.0
1589,Wind,22_05,1302798.0,0.0,154971463.0,0.0,154971463.0,0.0
1590,Wind,22_06,624916.0,0.0,155596379.0,0.0,155596379.0,0.0
1591,Wind,22_07,1029939.0,0.0,156626318.0,0.0,156626318.0,0.0
1592,Wind,22_08,2957321.0,0.0,159583639.0,0.0,159583639.0,0.0
1593,Wind,22_09,2783781.0,0.0,162367420.0,0.0,162367420.0,0.0
1594,Wind,22_10,942081.0,0.0,163309501.0,0.0,163309501.0,0.0
1595,Wind,22_11,4807264.0,0.0,168116765.0,0.0,168116765.0,0.0
1596,Wind,22_12,3651041.0,0.0,171767806.0,0.0,171767806.0,0.0
1597,Wind,23_01,2789038.0,0.0,174556844.0,0.0,174556844.0,0.0
1598,Wind,23_02,1326068.0,0.0,175882912.0,0.0,175882912.0,0.0
1599,Wind,23_03,2045663.0,0.0,177928575.0,0.0,177928575.0,0.0
1600,Wind,23_04,353685.0,0.0,178282260.0,0.0,178282260.0,0.0
1601,Wind,23_05,504642.0,0.0,178786902.0,0.0,178786902.0,0.0
1602,Wind,23_06,1358614.0,241890.0,180145516.0,241890.0,179903626.0,0.0013427478261518317
1603,Wind,23_07,2812480.0,368863.0,182957996.0,610753.0,182347243.0,0.0033382143079442126
